ID,DATE,WEEK,YEAR,WEEKNUM,TTL,TTL_TOTAL,TTL_BEFORE,GRP,GRP_OSAKA,GRP_TOKYO,GRP_NAGOYA,TTL2,GRP2
1,2013/7/2,3,2013,27,16690,16690,0,0,0,0,0,0,0
2,2013/7/3,4,2013,27,24463,41153,16690,0,0,0,0,20972.3,0.0
3,2013/7/4,5,2013,27,21764,62917,41153,0,0,0,0,23310.7,0.0
4,2013/7/5,6,2013,27,23705,86622,62917,0,0,0,0,25196.0,0.0
5,2013/7/6,7,2013,27,30119,116741,86622,0,0,0,0,23360.0,0.0
6,2013/7/7,1,2013,27,16256,132997,116741,0,0,0,0,20312.0,0.0
7,2013/7/8,2,2013,28,14561,147558,132997,0,0,0,0,13499.0,0.0
8,2013/7/9,3,2013,28,9680,157238,147558,0,0,0,0,11005.7,0.0
9,2013/7/10,4,2013,28,8776,166014,157238,0,0,0,0,7181.0,0.0
10,2013/7/11,5,2013,28,3087,169101,166014,0,0,0,0,4778.3,0.0
11,2013/7/12,6,2013,28,2472,171573,169101,0,0,0,0,2267.7,0.0
12,2013/7/13,7,2013,28,1244,172817,171573,0,0,0,0,1640.7,0.0
13,2013/7/14,1,2013,28,1206,174023,172817,0,0,0,0,1223.3,0.0
14,2013/7/15,2,2013,29,1220,175243,174023,0,0,0,0,2714.7,0.0
15,2013/7/16,3,2013,29,5718,180961,175243,0,0,0,0,5354.0,0.0
16,2013/7/17,4,2013,29,9124,190085,180961,0,0,0,0,8599.3,0.0
17,2013/7/18,5,2013,29,10956,201041,190085,0,0,0,0,10604.3,0.0
18,2013/7/19,6,2013,29,11733,212774,201041,0,0,0,0,11327.0,0.0
19,2013/7/20,7,2013,29,11292,224066,212774,0,0,0,0,11567.3,0.0
20,2013/7/21,1,2013,29,11677,235743,224066,0,0,0,0,10984.0,0.0
21,2013/7/22,2,2013,30,9983,245726,235743,0,0,0,0,11009.3,0.0
22,2013/7/23,3,2013,30,11368,257094,245726,0,0,0,0,10888.7,0.0
23,2013/7/24,4,2013,30,11315,268409,257094,0,0,0,0,11392.0,0.0
24,2013/7/25,5,2013,30,11493,279902,268409,0,0,0,0,10588.3,0.0
25,2013/7/26,6,2013,30,8957,288859,279902,0,0,0,0,9786.0,0.0
26,2013/7/27,7,2013,30,8908,297767,288859,0,0,0,0,9349.0,0.0
27,2013/7/28,1,2013,30,10182,307949,297767,0,0,0,0,9559.3,0.0
28,2013/7/29,2,2013,31,9588,317537,307949,0,0,0,0,9469.0,0.0
29,2013/7/30,3,2013,31,8637,326174,317537,0,0,0,0,8778.0,0.0
30,2013/7/31,4,2013,31,8109,334283,326174,0,0,0,0,7657.7,0.0
31,2013/8/1,5,2013,31,6227,340510,334283,0,0,0,0,6626.7,0.0
32,2013/8/2,6,2013,31,5544,346054,340510,0,0,0,0,6100.3,0.0
33,2013/8/3,7,2013,31,6530,352584,346054,0,0,0,0,6200.3,0.0
34,2013/8/4,1,2013,31,6527,359111,352584,0,0,0,0,6303.0,0.0
35,2013/8/5,2,2013,32,5852,364963,359111,0,0,0,0,6191.3,0.0
36,2013/8/6,3,2013,32,6195,371158,364963,0,0,0,0,25776.7,0.0
37,2013/8/7,4,2013,32,65283,436441,371158,0,0,0,0,40234.0,0.0
38,2013/8/8,5,2013,32,49224,485665,436441,0,0,0,0,45005.7,0.0
39,2013/8/9,6,2013,32,20510,506175,485665,0,0,0,0,26065.0,0.0
40,2013/8/10,7,2013,32,8461,514636,506175,0,0,0,0,11761.3,0.0
41,2013/8/11,1,2013,32,6313,520949,514636,0,0,0,0,6590.0,0.0
42,2013/8/12,2,2013,33,4996,525945,520949,0,0,0,0,5321.0,0.0
43,2013/8/13,3,2013,33,4654,530599,525945,0,0,0,0,4821.0,0.0
44,2013/8/14,4,2013,33,4813,535412,530599,0,0,0,0,4752.3,0.0
45,2013/8/15,5,2013,33,4790,540202,535412,0,0,0,0,4564.3,0.0
46,2013/8/16,6,2013,33,4090,544292,540202,0,0,0,0,4249.0,0.0
47,2013/8/17,7,2013,33,3867,548159,544292,0,0,0,0,3936.0,0.0
48,2013/8/18,1,2013,33,3851,552010,548159,0,0,0,0,3864.3,0.0
49,2013/8/19,2,2013,34,3875,555885,552010,0,0,0,0,3930.0,0.0
50,2013/8/20,3,2013,34,4064,559949,555885,0,0,0,0,3909.0,0.0
51,2013/8/21,4,2013,34,3788,563737,559949,0,0,0,0,3716.0,0.0
52,2013/8/22,5,2013,34,3296,567033,563737,0,0,0,0,14014.3,0.0
53,2013/8/23,6,2013,34,34959,601992,567033,0,0,0,0,22661.3,0.0
54,2013/8/24,7,2013,34,29729,631721,601992,0,0,0,0,31355.0,0.0
55,2013/8/25,1,2013,34,29377,661098,631721,0,0,0,0,23497.7,0.0
56,2013/8/26,2,2013,35,11387,672485,661098,0,0,0,0,16154.3,0.0
57,2013/8/27,3,2013,35,7699,680184,672485,0,0,0,0,8124.7,0.0
58,2013/8/28,4,2013,35,5288,685472,680184,0,0,0,0,5745.0,0.0
59,2013/8/29,5,2013,35,4248,689720,685472,0,0,0,0,4243.0,0.0
60,2013/8/30,6,2013,35,3193,692913,689720,0,0,0,0,3354.0,0.0
61,2013/8/31,7,2013,35,2621,695534,692913,0,0,0,0,2762.3,0.0
62,2013/9/1,1,2013,35,2473,698007,695534,0,0,0,0,2462.3,0.0
63,2013/9/2,2,2013,36,2293,700300,698007,0,0,0,0,2319.0,0.0
64,2013/9/3,3,2013,36,2191,702491,700300,0,0,0,0,2291.0,0.0
65,2013/9/4,4,2013,36,2389,704880,702491,0,0,0,0,2549.3,0.0
66,2013/9/5,5,2013,36,3068,707948,704880,0,0,0,0,2830.3,0.0
67,2013/9/6,6,2013,36,3034,710982,707948,0,0,0,0,3088.3,0.0
68,2013/9/7,7,2013,36,3163,714145,710982,0,0,0,0,2988.3,0.0
69,2013/9/8,1,2013,36,2768,716913,714145,0,0,0,0,2738.0,0.0
70,2013/9/9,2,2013,37,2283,719196,716913,0,0,0,0,2457.3,0.0
71,2013/9/10,3,2013,37,2321,721517,719196,0,0,0,0,2298.0,0.0
72,2013/9/11,4,2013,37,2290,723807,721517,0,0,0,0,2307.0,0.0
73,2013/9/12,5,2013,37,2310,726117,723807,0,0,0,0,2214.7,0.0
74,2013/9/13,6,2013,37,2044,728161,726117,0,0,0,0,2173.0,0.0
75,2013/9/14,7,2013,37,2165,730326,728161,0,0,0,0,2163.0,0.0
76,2013/9/15,1,2013,37,2280,732606,730326,0,0,0,0,2301.3,0.0
77,2013/9/16,2,2013,38,2459,735065,732606,0,0,0,0,2200.0,0.0
78,2013/9/17,3,2013,38,1861,736926,735065,0,0,0,0,2103.0,0.0
79,2013/9/18,4,2013,38,1989,738915,736926,0,0,0,0,1844.0,0.0
80,2013/9/19,5,2013,38,1682,740597,738915,0,0,0,0,1779.3,0.0
81,2013/9/20,6,2013,38,1667,742264,740597,0,0,0,0,1739.0,0.0
82,2013/9/21,7,2013,38,1868,744132,742264,0,0,0,0,1915.3,0.0
83,2013/9/22,1,2013,38,2211,746343,744132,0,0,0,0,2047.7,0.0
84,2013/9/23,2,2013,39,2064,748407,746343,0,0,0,0,2046.3,0.0
85,2013/9/24,3,2013,39,1864,750271,748407,0,0,0,0,1939.7,0.0
86,2013/9/25,4,2013,39,1891,752162,750271,0,0,0,0,1833.7,0.0
87,2013/9/26,5,2013,39,1746,753908,752162,0,0,0,0,1739.3,0.0
88,2013/9/27,6,2013,39,1581,755489,753908,0,0,0,0,1723.0,0.0
89,2013/9/28,7,2013,39,1842,757331,755489,0,0,0,0,1892.3,0.0
90,2013/9/29,1,2013,39,2254,759585,757331,0,0,0,0,2368.7,0.0
91,2013/9/30,2,2013,40,3010,762595,759585,0,0,0,0,2982.3,0.0
92,2013/10/1,3,2013,40,3683,766278,762595,0,0,0,0,3615.0,0.0
93,2013/10/2,4,2013,40,4152,770430,766278,0,0,0,0,4213.0,0.0
94,2013/10/3,5,2013,40,4804,775234,770430,0,0,0,0,4845.0,0.0
95,2013/10/4,6,2013,40,5579,780813,775234,0,0,0,0,5719.7,0.0
96,2013/10/5,7,2013,40,6776,787589,780813,0,0,0,0,6464.7,0.0
97,2013/10/6,1,2013,40,7039,794628,787589,0,0,0,0,6957.0,0.0
98,2013/10/7,2,2013,41,7056,801684,794628,0,0,0,0,7171.3,0.0
99,2013/10/8,3,2013,41,7419,809103,801684,0,0,0,0,7270.3,0.0
100,2013/10/9,4,2013,41,7336,816439,809103,0,0,0,0,7427.3,0.0
101,2013/10/10,5,2013,41,7527,823966,816439,0,0,0,0,8644.3,0.0
102,2013/10/11,6,2013,41,11070,835036,823966,0,0,0,0,10476.0,0.0
103,2013/10/12,7,2013,41,12831,847867,835036,0,0,0,0,12704.7,0.0
104,2013/10/13,1,2013,41,14213,862080,847867,0,0,0,0,14538.7,0.0
105,2013/10/14,2,2013,42,16572,878652,862080,0,0,0,0,16097.7,0.0
106,2013/10/15,3,2013,42,17508,896160,878652,0,0,0,0,17364.7,0.0
107,2013/10/16,4,2013,42,18014,914174,896160,0,0,0,0,18006.3,0.0
108,2013/10/17,5,2013,42,18497,932671,914174,0,0,0,0,17968.7,0.0
109,2013/10/18,6,2013,42,17395,950066,932671,0,0,0,0,18805.0,0.0
110,2013/10/19,7,2013,42,20523,970589,950066,0,0,0,0,19410.7,0.0
111,2013/10/20,1,2013,42,20314,990903,970589,0,0,0,0,19785.7,0.0
112,2013/10/21,2,2013,43,18520,1009423,990903,0,0,0,0,19261.7,0.0
113,2013/10/22,3,2013,43,18951,1028374,1009423,0,0,0,0,18865.7,0.0
114,2013/10/23,4,2013,43,19126,1047500,1028374,0,0,0,0,19017.7,0.0
115,2013/10/24,5,2013,43,18976,1066476,1047500,0,0,0,0,30495.0,0.0
116,2013/10/25,6,2013,43,53383,1119859,1066476,0,0,0,0,37033.3,0.0
117,2013/10/26,7,2013,43,38741,1158600,1119859,0,0,0,0,38683.7,0.0
118,2013/10/27,1,2013,43,23927,1182527,1158600,0,0,0,0,26837.0,0.0
119,2013/10/28,2,2013,44,17843,1200370,1182527,0,0,0,0,18783.7,0.0
120,2013/10/29,3,2013,44,14581,1214951,1200370,0,0,0,0,15030.0,0.0
121,2013/10/30,4,2013,44,12666,1227617,1214951,0,0,0,0,12794.0,0.0
122,2013/10/31,5,2013,44,11135,1238752,1227617,0,0,0,0,10814.0,0.0
123,2013/11/1,6,2013,44,8641,1247393,1238752,0,0,0,0,9366.7,0.0
124,2013/11/2,7,2013,44,8324,1255717,1247393,0,0,0,0,8587.7,0.0
125,2013/11/3,1,2013,44,8798,1264515,1255717,0,0,0,0,8594.0,0.0
126,2013/11/4,2,2013,45,8660,1273175,1264515,0,0,0,0,8648.7,0.0
127,2013/11/5,3,2013,45,8488,1281663,1273175,0,0,0,0,8168.3,0.0
128,2013/11/6,4,2013,45,7357,1289020,1281663,0,0,0,0,7568.3,0.0
129,2013/11/7,5,2013,45,6860,1295880,1289020,0,0,0,0,6936.3,0.0
130,2013/11/8,6,2013,45,6592,1302472,1295880,0,0,0,0,6726.3,0.0
131,2013/11/9,7,2013,45,6727,1309199,1302472,0,0,0,0,6780.0,0.0
132,2013/11/10,1,2013,45,7021,1316220,1309199,0,0,0,0,6650.0,0.0
133,2013/11/11,2,2013,46,6202,1322422,1316220,0,0,0,0,6456.3,0.0
134,2013/11/12,3,2013,46,6146,1328568,1322422,0,0,0,0,6145.7,0.0
135,2013/11/13,4,2013,46,6089,1334657,1328568,0,0,0,0,6087.0,0.0
136,2013/11/14,5,2013,46,6026,1340683,1334657,0,0,0,0,5825.7,0.0
137,2013/11/15,6,2013,46,5362,1346045,1340683,0,0,0,0,5567.7,0.0
138,2013/11/16,7,2013,46,5315,1351360,1346045,0,0,0,0,5273.0,0.0
139,2013/11/17,1,2013,46,5142,1356502,1351360,0,0,0,0,5059.3,0.0
140,2013/11/18,2,2013,47,4721,1361223,1356502,0,0,0,0,4873.0,0.0
141,2013/11/19,3,2013,47,4756,1365979,1361223,0,0,0,0,4640.7,0.0
142,2013/11/20,4,2013,47,4445,1370424,1365979,0,0,0,0,4497.0,0.0
143,2013/11/21,5,2013,47,4290,1374714,1370424,0,0,0,0,4215.0,0.0
144,2013/11/22,6,2013,47,3910,1378624,1374714,0,0,0,0,4137.0,0.0
145,2013/11/23,7,2013,47,4211,1382835,1378624,0,0,0,0,4115.3,0.0
146,2013/11/24,1,2013,47,4225,1387060,1382835,0,0,0,0,4404.0,3.6
147,2013/11/25,2,2013,48,4776,1391836,1387060,10.8,63.7,10.8,83.1,4674.3,19.8
148,2013/11/26,3,2013,48,5022,1396858,1391836,48.7,31.7,48.7,87,4951.7,26.5
149,2013/11/27,4,2013,48,5057,1401915,1396858,20,40.1,20,111.3,5027.7,29.8
150,2013/11/28,5,2013,48,5004,1406919,1401915,20.8,16,20.8,126.2,5164.7,28.4
151,2013/11/29,6,2013,48,5433,1412352,1406919,44.3,15.9,44.3,115.5,5519.0,29.1
152,2013/11/30,7,2013,48,6120,1418472,1412352,22.1,40,22.1,98.5,6107.3,33.5
153,2013/12/1,1,2013,48,6769,1425241,1418472,34,24.8,34,29.8,6457.0,39.7
154,2013/12/2,2,2013,49,6482,1431723,1425241,63.1,38,63.1,42,6875.7,49.6
155,2013/12/3,3,2013,49,7376,1439099,1431723,51.8,51.1,51.8,21.1,6975.0,56.5
156,2013/12/4,4,2013,49,7067,1446166,1439099,54.6,25.9,54.6,12.4,7296.3,54.1
157,2013/12/5,5,2013,49,7446,1453612,1446166,56,20.4,56,24.4,7310.7,52.9
158,2013/12/6,6,2013,49,7419,1461031,1453612,48.2,39.8,48.2,21.4,7818.0,63.5
159,2013/12/7,7,2013,49,8589,1469620,1461031,86.3,46.4,86.3,19.7,8511.3,67.2
160,2013/12/8,1,2013,49,9526,1479146,1469620,67.2,76.8,67.2,34,22705.3,73.5
161,2013/12/9,2,2013,50,50001,1529147,1479146,67.1,69.7,67.1,97.3,31922.3,72.1
162,2013/12/10,3,2013,50,36240,1565387,1529147,82,91.9,82,77.8,40729.0,74.6
163,2013/12/11,4,2013,50,35946,1601333,1565387,74.7,105.1,74.7,82.2,34854.7,89.7
164,2013/12/12,5,2013,50,32378,1633711,1601333,112.4,123.3,112.4,88.1,29192.3,85.0
165,2013/12/13,6,2013,50,19253,1652964,1633711,68,93.9,68,54.9,22155.7,86.9
166,2013/12/14,7,2013,50,14836,1667800,1652964,80.4,120.9,80.4,61.8,15469.3,70.3
167,2013/12/15,1,2013,50,12319,1680119,1667800,62.4,101.7,62.4,60.5,12759.0,66.5
168,2013/12/16,2,2013,51,11122,1691241,1680119,56.7,39.8,56.7,16.1,11519.7,47.8
169,2013/12/17,3,2013,51,11118,1702359,1691241,24.4,25,24.4,14.5,10964.0,33.7
170,2013/12/18,4,2013,51,10652,1713011,1702359,20.1,17.5,20.1,37,10580.3,26.1
171,2013/12/19,5,2013,51,9971,1722982,1713011,33.7,25.6,33.7,40.2,10073.7,26.4
172,2013/12/20,6,2013,51,9598,1732580,1722982,25.4,25.7,25.4,37.7,9787.0,36.3
173,2013/12/21,7,2013,51,9792,1742372,1732580,49.7,27.6,49.7,50.7,9672.0,46.1
174,2013/12/22,1,2013,51,9626,1751998,1742372,63.1,41.8,63.1,76.8,9605.0,48.6
175,2013/12/23,2,2013,52,9397,1761395,1751998,33,50.5,33,65.1,10212.3,49.5
176,2013/12/24,3,2013,52,11614,1773009,1761395,52.4,90.3,52.4,75.8,10441.7,37.4
177,2013/12/25,4,2013,52,10314,1783323,1773009,26.7,47.5,26.7,55.1,11396.3,43.5
178,2013/12/26,5,2013,52,12261,1795584,1783323,51.4,127.4,51.4,78.1,12350.0,50.3
179,2013/12/27,6,2013,52,14475,1810059,1795584,72.8,133.7,72.8,82.1,13385.3,41.4
180,2013/12/28,7,2013,52,13420,1823479,1810059,0,0,0,0,13262.0,24.3
181,2013/12/29,1,2013,52,11891,1835370,1823479,0,0,0,0,12534.7,10.2
182,2013/12/30,2,2013,53,12293,1847663,1835370,30.6,26.4,30.6,32,12300.3,19.3
183,2013/12/31,3,2013,53,12717,1860380,1847663,27.2,23.8,27.2,41.6,13247.7,30.5
184,2014/1/1,4,2014,1,14733,1875113,1860380,33.7,30.2,33.7,35,15031.7,29.7
185,2014/1/2,5,2014,1,17645,1892758,1875113,28.2,49.2,28.2,33,16155.3,24.0
186,2014/1/3,6,2014,1,16088,1908846,1892758,10,7,10,16.6,16253.0,26.3
187,2014/1/4,7,2014,1,15026,1923872,1908846,40.6,56.1,40.6,41.8,15654.3,40.4
188,2014/1/5,1,2014,1,15849,1939721,1923872,70.5,62.4,70.5,71.4,15581.0,54.9
189,2014/1/6,2,2014,2,15868,1955589,1939721,53.6,41.1,53.6,66.1,15390.0,57.3
190,2014/1/7,3,2014,2,14453,1970042,1955589,47.8,44.1,47.8,45.3,14784.0,50.3
191,2014/1/8,4,2014,2,14031,1984073,1970042,49.6,30.3,49.6,67.9,13917.0,44.9
192,2014/1/9,5,2014,2,13267,1997340,1984073,37.3,61.7,37.3,55,13113.3,38.5
193,2014/1/10,6,2014,2,12042,2009382,1997340,28.6,41.1,28.6,30.4,12515.0,39.2
194,2014/1/11,7,2014,2,12236,2021618,2009382,51.7,44.4,51.7,48.2,12314.3,48.6
195,2014/1/12,1,2014,2,12665,2034283,2021618,65.4,52.9,65.4,22.2,12400.3,45.7
196,2014/1/13,2,2014,3,12300,2046583,2034283,20.1,29.5,20.1,36.2,12196.7,32.4
197,2014/1/14,3,2014,3,11625,2058208,2046583,11.8,35.1,11.8,11.9,11231.0,10.6
198,2014/1/15,4,2014,3,9768,2067976,2058208,0,0,0,0,10262.3,5.9
199,2014/1/16,5,2014,3,9394,2077370,2067976,6,0,6,0,9293.3,2.0
200,2014/1/17,6,2014,3,8718,2086088,2077370,0,0,0,0,8845.7,2.0
201,2014/1/18,7,2014,3,8425,2094513,2086088,0,0,0,0,8314.3,0.0
202,2014/1/19,1,2014,3,7800,2102313,2094513,0,0,0,0,7746.7,0.0
203,2014/1/20,2,2014,4,7015,2109328,2102313,0,0,0,0,7399.7,0.0
204,2014/1/21,3,2014,4,7384,2116712,2109328,0,0,0,0,7094.3,1.3
205,2014/1/22,4,2014,4,6884,2123596,2116712,4,0,4,0,6805.3,1.3
206,2014/1/23,5,2014,4,6148,2129744,2123596,0,0,0,0,6479.0,1.3
207,2014/1/24,6,2014,4,6405,2136149,2129744,0,0,0,0,6309.7,0.0
208,2014/1/25,7,2014,4,6376,2142525,2136149,0,0,0,0,6446.7,0.0
209,2014/1/26,1,2014,4,6559,2149084,2142525,0,0,0,0,6173.7,0.0
210,2014/1/27,2,2014,5,5586,2154670,2149084,0,0,0,0,5657.7,0.0
211,2014/1/28,3,2014,5,4828,2159498,2154670,0,0,0,0,4965.7,0.0
212,2014/1/29,4,2014,5,4483,2163981,2159498,0,0,0,0,4549.7,0.0
213,2014/1/30,5,2014,5,4338,2168319,2163981,0,0,0,0,4316.7,0.0
214,2014/1/31,6,2014,5,4129,2172448,2168319,0,0,0,0,4397.7,0.0
215,2014/2/1,7,2014,5,4726,2177174,2172448,0,0,0,0,4658.3,0.0
216,2014/2/2,1,2014,5,5120,2182294,2177174,0,0,0,0,4816.3,0.0
217,2014/2/3,2,2014,6,4603,2186897,2182294,0,0,0,0,4732.3,0.0
218,2014/2/4,3,2014,6,4474,2191371,2186897,0,0,0,0,4498.3,0.0
219,2014/2/5,4,2014,6,4418,2195789,2191371,0,0,0,0,4410.3,0.0
220,2014/2/6,5,2014,6,4339,2200128,2195789,0,0,0,0,4364.0,0.0
221,2014/2/7,6,2014,6,4335,2204463,2200128,0,0,0,0,4421.0,0.0
222,2014/2/8,7,2014,6,4589,2209052,2204463,0,0,0,0,4464.7,0.0
223,2014/2/9,1,2014,6,4470,2213522,2209052,0,0,0,0,4391.7,0.0
224,2014/2/10,2,2014,7,4116,2217638,2213522,0,0,0,0,4212.7,0.0
225,2014/2/11,3,2014,7,4052,2221690,2217638,0,0,0,0,3908.7,0.0
226,2014/2/12,4,2014,7,3558,2225248,2221690,0,0,0,0,3852.3,0.0
227,2014/2/13,5,2014,7,3947,2229195,2225248,0,0,0,0,4017.3,0.0
228,2014/2/14,6,2014,7,4547,2233742,2229195,0,0,0,0,5196.3,57.6
229,2014/2/15,7,2014,7,7095,2240837,2233742,172.9,67.6,172.9,57.6,7381.3,102.9
230,2014/2/16,1,2014,7,10502,2251339,2240837,135.9,114.9,135.9,106.4,9416.0,122.1
231,2014/2/17,2,2014,8,10651,2261990,2251339,57.4,33.2,57.4,48.6,10272.3,86.9
232,2014/2/18,3,2014,8,9664,2271654,2261990,67.4,43.6,67.4,98.2,24109.3,67.5
233,2014/2/19,4,2014,8,52013,2323667,2271654,77.8,85.1,77.8,82.2,35340.7,67.8
234,2014/2/20,5,2014,8,44345,2368012,2323667,58.3,54.9,58.3,44,39543.7,62.3
235,2014/2/21,6,2014,8,22273,2390285,2368012,50.8,53.3,50.8,16.6,27372.3,59.7
236,2014/2/22,7,2014,8,15499,2405784,2390285,70,36.2,70,78.9,17430.0,60.8
237,2014/2/23,1,2014,8,14518,2420302,2405784,61.7,85.9,61.7,67.2,14273.0,60.7
238,2014/2/24,2,2014,9,12802,2433104,2420302,50.3,34.5,50.3,53,13125.0,48.2
239,2014/2/25,3,2014,9,12055,2445159,2433104,32.5,51,32.5,28.8,20146.0,42.8
240,2014/2/26,4,2014,9,35581,2480740,2445159,45.6,22.2,45.6,31.5,26867.0,34.0
241,2014/2/27,5,2014,9,32965,2513705,2480740,24,16.4,24,41.3,34121.3,29.3
242,2014/2/28,6,2014,9,33818,2547523,2513705,18.3,50.2,18.3,24.9,29335.3,15.1
243,2014/3/1,7,2014,9,21223,2568746,2547523,3,11.7,3,8.7,22167.7,9.1
244,2014/3/2,1,2014,9,11462,2580208,2568746,6,19.2,6,1.8,13768.7,3.3
245,2014/3/3,2,2014,10,8621,2588829,2580208,1,5.8,1,11.4,9338.7,2.6
246,2014/3/4,3,2014,10,7933,2596762,2588829,0.7,9.1,0.7,12.3,8110.7,0.8
247,2014/3/5,4,2014,10,7778,2604540,2596762,0.7,4.8,0.7,27.7,7689.7,0.7
248,2014/3/6,5,2014,10,7358,2611898,2604540,0.8,2.5,0.8,11,7459.3,1.2
249,2014/3/7,6,2014,10,7242,2619140,2611898,2,3.3,2,19.1,7441.7,1.4
250,2014/3/8,7,2014,10,7725,2626865,2619140,1.5,17.1,1.5,12.5,7551.3,1.6
251,2014/3/9,1,2014,10,7687,2634552,2626865,1.3,12,1.3,15.4,7563.0,0.9
252,2014/3/10,2,2014,11,7277,2641829,2634552,0,0,0,0,7353.0,0.4
253,2014/3/11,3,2014,11,7095,2648924,2641829,0,0,0,0,7115.3,0.0
254,2014/3/12,4,2014,11,6974,2655898,2648924,0,0,0,0,6910.7,0.0
255,2014/3/13,5,2014,11,6663,2662561,2655898,0,0,0,0,6502.7,0.0
256,2014/3/14,6,2014,11,5871,2668432,2662561,0,0,0,0,5963.3,0.0
257,2014/3/15,7,2014,11,5356,2673788,2668432,0,0,0,0,5481.0,0.0
258,2014/3/16,1,2014,11,5216,2679004,2673788,0,0,0,0,5109.7,0.0
259,2014/3/17,2,2014,12,4757,2683761,2679004,0,0,0,0,4753.7,0.0
260,2014/3/18,3,2014,12,4288,2688049,2683761,0,0,0,0,4330.3,0.0
261,2014/3/19,4,2014,12,3946,2691995,2688049,0,0,0,0,4059.3,0.0
262,2014/3/20,5,2014,12,3944,2695939,2691995,0,0,0,0,3923.3,0.0
263,2014/3/21,6,2014,12,3880,2699819,2695939,0,0,0,0,3860.0,0.0
264,2014/3/22,7,2014,12,3756,2703575,2699819,0,0,0,0,3816.3,0.0
265,2014/3/23,1,2014,12,3813,2707388,2703575,0,0,0,0,3853.0,0.0
266,2014/3/24,2,2014,13,3990,2711378,2707388,0,0,0,0,4651.7,0.0
267,2014/3/25,3,2014,13,6152,2717530,2711378,0,0,0,0,6078.7,0.0
268,2014/3/26,4,2014,13,8094,2725624,2717530,0,0,0,0,7278.7,0.0
269,2014/3/27,5,2014,13,7590,2733214,2725624,0,0,0,0,7591.3,0.0
270,2014/3/28,6,2014,13,7090,2740304,2733214,0,0,0,0,7283.3,0.0
271,2014/3/29,7,2014,13,7170,2747474,2740304,0,0,0,0,7644.7,0.0
272,2014/3/30,1,2014,13,8674,2756148,2747474,0,0,0,0,8428.7,0.0
273,2014/3/31,2,2014,14,9442,2765590,2756148,0,0,0,0,8924.7,0.0
274,2014/4/1,3,2014,14,8658,2774248,2765590,0,0,0,0,8752.0,0.0
275,2014/4/2,4,2014,14,8156,2782404,2774248,0,0,0,0,8266.0,0.0
276,2014/4/3,5,2014,14,7984,2790388,2782404,0,0,0,0,8145.3,0.0
277,2014/4/4,6,2014,14,8296,2798684,2790388,0,0,0,0,8364.7,0.0
278,2014/4/5,7,2014,14,8814,2807498,2798684,0,0,0,0,8650.0,0.0
279,2014/4/6,1,2014,14,8840,2816338,2807498,0,0,0,0,8506.0,0.0
280,2014/4/7,2,2014,15,7864,2824202,2816338,0,0,0,0,8074.7,0.0
281,2014/4/8,3,2014,15,7520,2831722,2824202,0,0,0,0,7600.0,0.0
282,2014/4/9,4,2014,15,7416,2839138,2831722,0,0,0,0,7294.7,0.0
283,2014/4/10,5,2014,15,6948,2846086,2839138,0,0,0,0,7084.0,0.0
284,2014/4/11,6,2014,15,6888,2852974,2846086,0,0,0,0,7086.0,0.0
285,2014/4/12,7,2014,15,7422,2860396,2852974,0,0,0,0,7504.7,0.0
286,2014/4/13,1,2014,15,8204,2868600,2860396,0,0,0,0,7715.3,0.0
287,2014/4/14,2,2014,16,7520,2876120,2868600,0,0,0,0,7617.3,0.0
288,2014/4/15,3,2014,16,7128,2883248,2876120,0,0,0,0,7170.0,0.0
289,2014/4/16,4,2014,16,6862,2890110,2883248,0,0,0,0,6980.0,0.0
290,2014/4/17,5,2014,16,6950,2897060,2890110,0,0,0,0,7040.7,0.0
291,2014/4/18,6,2014,16,7310,2904370,2897060,0,0,0,0,7314.7,0.0
292,2014/4/19,7,2014,16,7684,2912054,2904370,0,0,0,0,7700.0,0.0
293,2014/4/20,1,2014,16,8106,2920160,2912054,0,0,0,0,7673.3,0.0
294,2014/4/21,2,2014,17,7230,2927390,2920160,0,0,0,0,7478.0,0.0
295,2014/4/22,3,2014,17,7098,2934488,2927390,0,0,0,0,7010.7,0.0
296,2014/4/23,4,2014,17,6704,2941192,2934488,0,0,0,0,9517.3,0.0
297,2014/4/24,5,2014,17,14750,2955942,2941192,0,0,0,0,20771.3,0.0
298,2014/4/25,6,2014,17,40860,2996802,2955942,0,0,0,0,55053.3,0.0
299,2014/4/26,7,2014,17,109550,3106352,2996802,0,0,0,0,83838.7,0.0
300,2014/4/27,1,2014,17,101106,3207458,3106352,0,0,0,0,92547.3,0.0
301,2014/4/28,2,2014,18,66986,3274444,3207458,0,0,0,0,70764.7,0.0
302,2014/4/29,3,2014,18,44202,3318646,3274444,0,0,0,0,50422.0,0.0
303,2014/4/30,4,2014,18,40078,3358724,3318646,0,0,0,0,41209.7,0.0
304,2014/5/1,5,2014,18,39349,3398073,3358724,0,0,0,0,37325.3,0.0
305,2014/5/2,6,2014,18,32549,3430622,3398073,0,0,0,0,33962.0,0.0
306,2014/5/3,7,2014,18,29988,3460610,3430622,0,0,0,0,30247.0,0.0
307,2014/5/4,1,2014,18,28204,3488814,3460610,0,0,0,0,29662.7,0.0
308,2014/5/5,2,2014,19,30796,3519610,3488814,0,0,0,0,28192.7,0.0
309,2014/5/6,3,2014,19,25578,3545188,3519610,0,0,0,0,25787.3,0.0
310,2014/5/7,4,2014,19,20988,3566176,3545188,0,0,0,0,21804.7,0.0
311,2014/5/8,5,2014,19,18848,3585024,3566176,0,0,0,0,18831.0,0.0
312,2014/5/9,6,2014,19,16657,3601681,3585024,0,0,0,0,16979.3,0.0
313,2014/5/10,7,2014,19,15433,3617114,3601681,0,0,0,0,15955.3,0.0
314,2014/5/11,1,2014,19,15776,3632890,3617114,0,0,0,0,11906.0,0.0
315,2014/5/12,2,2014,20,4509,3637399,3632890,0,0,0,0,10142.5,0.0
