ID,Date,WEEK,Country,Unified App,TTL,TTL_TOTAL,TTL_BEFORE,GRP,TTL2,GRP2
1,2015/8/3,1,Japan,C Channel,0,0,0,0,0.0,0.0
2,2015/8/4,2,Japan,C Channel,0,0,0,0,7.0,0.0
3,2015/8/5,3,Japan,C Channel,21,21,0,0,13.7,0.0
4,2015/8/6,4,Japan,C Channel,20,41,21,0,20.3,0.0
5,2015/8/7,5,Japan,C Channel,20,61,41,0,13.3,0.0
6,2015/8/8,6,Japan,C Channel,0,61,61,0,6.7,0.0
7,2015/8/9,7,Japan,C Channel,0,61,61,0,5.7,0.0
8,2015/8/10,1,Japan,C Channel,17,78,61,0,5.7,0.0
9,2015/8/11,2,Japan,C Channel,0,78,78,0,5.7,0.0
10,2015/8/12,3,Japan,C Channel,0,78,78,0,0.0,0.0
11,2015/8/13,4,Japan,C Channel,0,78,78,0,39.7,0.0
12,2015/8/14,5,Japan,C Channel,119,197,78,0,67.3,0.0
13,2015/8/15,6,Japan,C Channel,83,280,197,0,81.3,0.0
14,2015/8/16,7,Japan,C Channel,42,322,280,0,51.7,0.0
15,2015/8/17,1,Japan,C Channel,30,352,322,0,36.0,0.0
16,2015/8/18,2,Japan,C Channel,36,388,352,0,35.0,0.0
17,2015/8/19,3,Japan,C Channel,39,427,388,0,52.3,0.0
18,2015/8/20,4,Japan,C Channel,82,509,427,0,65.0,0.0
19,2015/8/21,5,Japan,C Channel,74,583,509,0,73.0,0.0
20,2015/8/22,6,Japan,C Channel,63,646,583,0,64.7,0.0
21,2015/8/23,7,Japan,C Channel,57,703,646,0,59.0,0.0
22,2015/8/24,1,Japan,C Channel,57,760,703,0,54.7,0.0
23,2015/8/25,2,Japan,C Channel,50,810,760,0,49.7,0.0
24,2015/8/26,3,Japan,C Channel,42,852,810,0,45.3,0.0
25,2015/8/27,4,Japan,C Channel,44,896,852,0,38.3,0.0
26,2015/8/28,5,Japan,C Channel,29,925,896,0,48.0,0.0
27,2015/8/29,6,Japan,C Channel,71,996,925,0,52.3,0.0
28,2015/8/30,7,Japan,C Channel,57,1053,996,0,53.3,0.0
29,2015/8/31,1,Japan,C Channel,32,1085,1053,0,50.3,0.0
30,2015/9/1,2,Japan,C Channel,62,1147,1085,0,58.3,0.0
31,2015/9/2,3,Japan,C Channel,81,1228,1147,0,97.7,0.0
32,2015/9/3,4,Japan,C Channel,150,1378,1228,0,105.0,0.0
33,2015/9/4,5,Japan,C Channel,84,1462,1378,0,106.3,0.0
34,2015/9/5,6,Japan,C Channel,85,1547,1462,0,95.7,0.0
35,2015/9/6,7,Japan,C Channel,118,1665,1547,0,129.0,0.0
36,2015/9/7,1,Japan,C Channel,184,1849,1665,0,158.3,0.0
37,2015/9/8,2,Japan,C Channel,173,2022,1849,0,168.3,0.0
38,2015/9/9,3,Japan,C Channel,148,2170,2022,0,146.7,0.0
39,2015/9/10,4,Japan,C Channel,119,2289,2170,0,126.0,0.0
40,2015/9/11,5,Japan,C Channel,111,2400,2289,0,110.7,0.0
41,2015/9/12,6,Japan,C Channel,102,2502,2400,0,99.7,0.0
42,2015/9/13,7,Japan,C Channel,86,2588,2502,0,100.7,0.0
43,2015/9/14,1,Japan,C Channel,114,2702,2588,0,109.7,0.0
44,2015/9/15,2,Japan,C Channel,129,2831,2702,0,113.0,0.0
45,2015/9/16,3,Japan,C Channel,96,2927,2831,0,102.3,0.0
46,2015/9/17,4,Japan,C Channel,82,3009,2927,0,75.7,0.0
47,2015/9/18,5,Japan,C Channel,49,3058,3009,0,64.3,0.0
48,2015/9/19,6,Japan,C Channel,62,3120,3058,0,55.7,0.0
49,2015/9/20,7,Japan,C Channel,56,3176,3120,0,59.3,0.0
50,2015/9/21,1,Japan,C Channel,60,3236,3176,0,57.0,0.0
51,2015/9/22,2,Japan,C Channel,55,3291,3236,0,134.0,0.0
52,2015/9/23,3,Japan,C Channel,287,3578,3291,0,168.0,0.0
53,2015/9/24,4,Japan,C Channel,162,3740,3578,0,186.3,0.0
54,2015/9/25,5,Japan,C Channel,110,3850,3740,0,126.0,0.0
55,2015/9/26,6,Japan,C Channel,106,3956,3850,0,125.7,0.0
56,2015/9/27,7,Japan,C Channel,161,4117,3956,0,128.3,0.0
57,2015/9/28,1,Japan,C Channel,118,4235,4117,0,118.0,0.0
58,2015/9/29,2,Japan,C Channel,75,4310,4235,0,90.0,0.0
59,2015/9/30,3,Japan,C Channel,77,4387,4310,0,80.7,0.0
60,2015/10/1,4,Japan,C Channel,90,4477,4387,0,89.7,0.0
61,2015/10/2,5,Japan,C Channel,102,4579,4477,0,86.3,0.0
62,2015/10/3,6,Japan,C Channel,67,4646,4579,0,76.0,0.0
63,2015/10/4,7,Japan,C Channel,59,4705,4646,0,58.0,0.0
64,2015/10/5,1,Japan,C Channel,48,4753,4705,0,50.7,0.0
65,2015/10/6,2,Japan,C Channel,45,4798,4753,0,58.0,0.0
66,2015/10/7,3,Japan,C Channel,81,4879,4798,0,66.3,0.0
67,2015/10/8,4,Japan,C Channel,73,4952,4879,0,117.0,0.0
68,2015/10/9,5,Japan,C Channel,197,5149,4952,0,122.7,0.0
69,2015/10/10,6,Japan,C Channel,98,5247,5149,0,130.0,0.0
70,2015/10/11,7,Japan,C Channel,95,5342,5247,0,92.7,0.0
71,2015/10/12,1,Japan,C Channel,85,5427,5342,0,86.0,0.0
72,2015/10/13,2,Japan,C Channel,78,5505,5427,0,91.0,0.0
73,2015/10/14,3,Japan,C Channel,110,5615,5505,0,93.3,0.0
74,2015/10/15,4,Japan,C Channel,92,5707,5615,0,94.3,0.0
75,2015/10/16,5,Japan,C Channel,81,5788,5707,0,98.0,0.0
76,2015/10/17,6,Japan,C Channel,121,5909,5788,0,87.7,0.0
77,2015/10/18,7,Japan,C Channel,61,5970,5909,0,73.3,0.0
78,2015/10/19,1,Japan,C Channel,38,6008,5970,0,63.7,0.0
79,2015/10/20,2,Japan,C Channel,92,6100,6008,0,66.3,0.0
80,2015/10/21,3,Japan,C Channel,69,6169,6100,0,75.3,0.0
81,2015/10/22,4,Japan,C Channel,65,6234,6169,0,70.7,0.0
82,2015/10/23,5,Japan,C Channel,78,6312,6234,0,81.3,0.0
83,2015/10/24,6,Japan,C Channel,101,6413,6312,0,98.3,0.0
84,2015/10/25,7,Japan,C Channel,116,6529,6413,0,101.0,0.0
85,2015/10/26,1,Japan,C Channel,86,6615,6529,0,121.3,0.0
86,2015/10/27,2,Japan,C Channel,162,6777,6615,0,142.7,0.0
87,2015/10/28,3,Japan,C Channel,180,6957,6777,0,175.3,0.0
88,2015/10/29,4,Japan,C Channel,184,7141,6957,0,220.7,0.0
89,2015/10/30,5,Japan,C Channel,298,7439,7141,0,232.7,0.0
90,2015/10/31,6,Japan,C Channel,216,7655,7439,0,233.7,0.0
91,2015/11/1,7,Japan,C Channel,187,7842,7655,0,175.0,0.0
92,2015/11/2,1,Japan,C Channel,122,7964,7842,0,152.0,0.0
93,2015/11/3,2,Japan,C Channel,147,8111,7964,0,155.3,0.0
94,2015/11/4,3,Japan,C Channel,197,8308,8111,0,168.0,0.0
95,2015/11/5,4,Japan,C Channel,160,8468,8308,0,214.0,0.0
96,2015/11/6,5,Japan,C Channel,285,8753,8468,0,414.0,0.0
97,2015/11/7,6,Japan,C Channel,797,9550,8753,0,601.7,0.0
98,2015/11/8,7,Japan,C Channel,723,10273,9550,0,651.0,0.0
99,2015/11/9,1,Japan,C Channel,433,10706,10273,0,511.7,0.0
100,2015/11/10,2,Japan,C Channel,379,11085,10706,0,377.3,0.0
101,2015/11/11,3,Japan,C Channel,320,11405,11085,0,289.3,0.0
102,2015/11/12,4,Japan,C Channel,169,11574,11405,0,197.7,0.0
103,2015/11/13,5,Japan,C Channel,104,11678,11574,0,117.3,0.0
104,2015/11/14,6,Japan,C Channel,79,11757,11678,0,79.0,0.0
105,2015/11/15,7,Japan,C Channel,54,11811,11757,0,52.7,0.0
106,2015/11/16,1,Japan,C Channel,25,11836,11811,0,130.3,0.0
107,2015/11/17,2,Japan,C Channel,312,12148,11836,0,574.0,0.0
108,2015/11/18,3,Japan,C Channel,1385,13533,12148,0,1193.0,0.0
109,2015/11/19,4,Japan,C Channel,1882,15415,13533,0,1691.3,0.0
110,2015/11/20,5,Japan,C Channel,1807,17222,15415,0,1959.7,0.0
111,2015/11/21,6,Japan,C Channel,2190,19412,17222,0,2021.3,0.0
112,2015/11/22,7,Japan,C Channel,2067,21479,19412,0,2158.3,0.0
113,2015/11/23,1,Japan,C Channel,2218,23697,21479,0,2079.3,0.0
114,2015/11/24,2,Japan,C Channel,1953,25650,23697,0,2542.7,0.0
115,2015/11/25,3,Japan,C Channel,3457,29107,25650,0,3043.7,0.0
116,2015/11/26,4,Japan,C Channel,3721,32828,29107,0,3739.0,0.0
117,2015/11/27,5,Japan,C Channel,4039,36867,32828,0,4281.0,0.0
118,2015/11/28,6,Japan,C Channel,5083,41950,36867,0,4407.3,0.0
119,2015/11/29,7,Japan,C Channel,4100,46050,41950,0,4184.3,0.0
120,2015/11/30,1,Japan,C Channel,3370,49420,46050,0,3124.0,0.0
121,2015/12/1,2,Japan,C Channel,1902,51322,49420,0,2108.0,0.0
122,2015/12/2,3,Japan,C Channel,1052,52374,51322,0,1169.0,0.0
123,2015/12/3,4,Japan,C Channel,553,52927,52374,0,648.0,0.0
124,2015/12/4,5,Japan,C Channel,339,53266,52927,0,359.7,0.0
125,2015/12/5,6,Japan,C Channel,187,53453,53266,0,219.0,0.0
126,2015/12/6,7,Japan,C Channel,131,53584,53453,0,152.7,0.0
127,2015/12/7,1,Japan,C Channel,140,53724,53584,0,115.7,0.0
128,2015/12/8,2,Japan,C Channel,76,53800,53724,0,96.0,0.0
129,2015/12/9,3,Japan,C Channel,72,53872,53800,0,74.3,0.0
130,2015/12/10,4,Japan,C Channel,75,53947,53872,0,72.7,0.0
131,2015/12/11,5,Japan,C Channel,71,54018,53947,0,65.3,0.0
132,2015/12/12,6,Japan,C Channel,50,54068,54018,0,56.0,0.0
133,2015/12/13,7,Japan,C Channel,47,54115,54068,0,48.0,0.0
134,2015/12/14,1,Japan,C Channel,47,54162,54115,0,58.7,0.0
135,2015/12/15,2,Japan,C Channel,82,54244,54162,0,68.7,0.0
136,2015/12/16,3,Japan,C Channel,77,54321,54244,0,69.7,0.0
137,2015/12/17,4,Japan,C Channel,50,54371,54321,0,59.7,0.0
138,2015/12/18,5,Japan,C Channel,52,54423,54371,0,66.0,0.0
139,2015/12/19,6,Japan,C Channel,96,54519,54423,0,73.7,0.0
140,2015/12/20,7,Japan,C Channel,73,54592,54519,0,73.7,0.0
141,2015/12/21,1,Japan,C Channel,52,54644,54592,0,67.3,0.0
142,2015/12/22,2,Japan,C Channel,77,54721,54644,0,105.0,0.0
143,2015/12/23,3,Japan,C Channel,186,54907,54721,0,118.3,0.0
144,2015/12/24,4,Japan,C Channel,92,54999,54907,0,126.3,0.0
145,2015/12/25,5,Japan,C Channel,101,55100,54999,0,92.0,0.0
146,2015/12/26,6,Japan,C Channel,83,55183,55100,0,84.3,0.0
147,2015/12/27,7,Japan,C Channel,69,55252,55183,0,70.7,0.0
148,2015/12/28,1,Japan,C Channel,60,55312,55252,0,67.0,0.0
149,2015/12/29,2,Japan,C Channel,72,55384,55312,0,62.0,0.0
150,2015/12/30,3,Japan,C Channel,54,55438,55384,0,67.0,0.0
151,2015/12/31,4,Japan,C Channel,75,55513,55438,0,63.3,0.0
152,2016/1/1,5,Japan,C Channel,61,55574,55513,0,67.7,0.0
153,2016/1/2,6,Japan,C Channel,67,55641,55574,0,62.0,0.0
154,2016/1/3,7,Japan,C Channel,58,55699,55641,0,56.7,0.0
155,2016/1/4,1,Japan,C Channel,45,55744,55699,0,49.0,0.0
156,2016/1/5,2,Japan,C Channel,44,55788,55744,0,54.0,0.0
157,2016/1/6,3,Japan,C Channel,73,55861,55788,0,62.0,0.0
158,2016/1/7,4,Japan,C Channel,69,55930,55861,0,87.0,0.0
159,2016/1/8,5,Japan,C Channel,119,56049,55930,0,110.3,0.0
160,2016/1/9,6,Japan,C Channel,143,56192,56049,0,129.3,0.0
161,2016/1/10,7,Japan,C Channel,126,56318,56192,0,134.0,0.0
162,2016/1/11,1,Japan,C Channel,133,56451,56318,0,117.3,0.0
163,2016/1/12,2,Japan,C Channel,93,56544,56451,0,103.0,0.0
164,2016/1/13,3,Japan,C Channel,83,56627,56544,0,87.0,0.0
165,2016/1/14,4,Japan,C Channel,85,56712,56627,0,82.7,0.0
166,2016/1/15,5,Japan,C Channel,80,56792,56712,0,83.0,0.0
167,2016/1/16,6,Japan,C Channel,84,56876,56792,0,78.0,0.0
168,2016/1/17,7,Japan,C Channel,70,56946,56876,0,80.7,0.0
169,2016/1/18,1,Japan,C Channel,88,57034,56946,0,86.3,0.0
170,2016/1/19,2,Japan,C Channel,101,57135,57034,0,102.7,0.0
171,2016/1/20,3,Japan,C Channel,119,57254,57135,0,2955.3,0.0
172,2016/1/21,4,Japan,C Channel,8646,65900,57254,0,6254.0,0.0
173,2016/1/22,5,Japan,C Channel,9997,75897,65900,0,10109.3,0.0
174,2016/1/23,6,Japan,C Channel,11685,87582,75897,0,9756.0,0.0
175,2016/1/24,7,Japan,C Channel,7586,95168,87582,0,8519.3,0.0
176,2016/1/25,1,Japan,C Channel,6287,101455,95168,0,6359.7,0.0
177,2016/1/26,2,Japan,C Channel,5206,106661,101455,0,5779.7,0.0
178,2016/1/27,3,Japan,C Channel,5846,112507,106661,0,5770.0,0.0
179,2016/1/28,4,Japan,C Channel,6258,118765,112507,0,5438.7,0.0
180,2016/1/29,5,Japan,C Channel,4212,122977,118765,0,4065.3,0.0
181,2016/1/30,6,Japan,C Channel,1726,124703,122977,0,2422.0,0.0
182,2016/1/31,7,Japan,C Channel,1328,126031,124703,0,1482.3,0.0
183,2016/2/1,1,Japan,C Channel,1393,127424,126031,0,1449.0,0.0
184,2016/2/2,2,Japan,C Channel,1626,129050,127424,0,1635.7,0.0
185,2016/2/3,3,Japan,C Channel,1888,130938,129050,0,1739.3,0.0
186,2016/2/4,4,Japan,C Channel,1704,132642,130938,0,1738.7,0.0
187,2016/2/5,5,Japan,C Channel,1624,134266,132642,0,1723.3,0.0
188,2016/2/6,6,Japan,C Channel,1842,136108,134266,0,1857.3,0.0
189,2016/2/7,7,Japan,C Channel,2106,138214,136108,0,1931.7,0.0
190,2016/2/8,1,Japan,C Channel,1847,140061,138214,0,2069.0,0.0
191,2016/2/9,2,Japan,C Channel,2254,142315,140061,0,1985.3,0.0
192,2016/2/10,3,Japan,C Channel,1855,144170,142315,0,2088.0,0.0
193,2016/2/11,4,Japan,C Channel,2155,146325,144170,0,1930.3,0.0
194,2016/2/12,5,Japan,C Channel,1781,148106,146325,0,1945.0,0.0
195,2016/2/13,6,Japan,C Channel,1899,150005,148106,0,1796.3,0.0
196,2016/2/14,7,Japan,C Channel,1709,151714,150005,0,1749.0,0.0
197,2016/2/15,1,Japan,C Channel,1639,153353,151714,0,1659.7,0.0
198,2016/2/16,2,Japan,C Channel,1631,154984,153353,0,2465.0,0.0
199,2016/2/17,3,Japan,C Channel,4125,159109,154984,0,4054.3,0.0
200,2016/2/18,4,Japan,C Channel,6407,165516,159109,0,5870.3,0.0
201,2016/2/19,5,Japan,C Channel,7079,172595,165516,0,6511.7,0.0
202,2016/2/20,6,Japan,C Channel,6049,178644,172595,0,6454.3,0.0
203,2016/2/21,7,Japan,C Channel,6235,184879,178644,0,5785.7,0.0
204,2016/2/22,1,Japan,C Channel,5073,189952,184879,0,5835.3,0.0
205,2016/2/23,2,Japan,C Channel,6198,196150,189952,0,6001.7,0.0
206,2016/2/24,3,Japan,C Channel,6734,202884,196150,0,6011.3,0.0
207,2016/2/25,4,Japan,C Channel,5102,207986,202884,0,6290.7,0.0
208,2016/2/26,5,Japan,C Channel,7036,215022,207986,0,6423.7,0.0
209,2016/2/27,6,Japan,C Channel,7133,222155,215022,0,7312.0,0.0
210,2016/2/28,7,Japan,C Channel,7767,229922,222155,0,7603.0,0.0
211,2016/2/29,1,Japan,C Channel,7909,237831,229922,0,8099.0,0.0
212,2016/3/1,2,Japan,C Channel,8621,246452,237831,0,7896.3,0.0
213,2016/3/2,3,Japan,C Channel,7159,253611,246452,0,7800.0,0.0
214,2016/3/3,4,Japan,C Channel,7620,261231,253611,0,7535.0,0.0
215,2016/3/4,5,Japan,C Channel,7826,269057,261231,0,6707.7,0.0
216,2016/3/5,6,Japan,C Channel,4677,273734,269057,0,6515.3,0.0
217,2016/3/6,7,Japan,C Channel,7043,280777,273734,0,5798.3,0.0
218,2016/3/7,1,Japan,C Channel,5675,286452,280777,0,6777.7,0.0
219,2016/3/8,2,Japan,C Channel,7615,294067,286452,0,6525.3,0.0
220,2016/3/9,3,Japan,C Channel,6286,300353,294067,0,6884.3,0.0
221,2016/3/10,4,Japan,C Channel,6752,307105,300353,0,6151.0,0.0
222,2016/3/11,5,Japan,C Channel,5415,312520,307105,0,5392.3,0.0
223,2016/3/12,6,Japan,C Channel,4010,316530,312520,0,5127.3,0.0
224,2016/3/13,7,Japan,C Channel,5957,322487,316530,0,4927.3,0.0
225,2016/3/14,1,Japan,C Channel,4815,327302,322487,0,5051.3,0.0
226,2016/3/15,2,Japan,C Channel,4382,331684,327302,0,4538.3,0.0
227,2016/3/16,3,Japan,C Channel,4418,336102,331684,0,4329.3,0.0
228,2016/3/17,4,Japan,C Channel,4188,340290,336102,0,4142.0,0.0
229,2016/3/18,5,Japan,C Channel,3820,344110,340290,0,3866.0,0.0
230,2016/3/19,6,Japan,C Channel,3590,347700,344110,0,4011.3,0.0
231,2016/3/20,7,Japan,C Channel,4624,352324,347700,0,4176.7,0.0
232,2016/3/21,1,Japan,C Channel,4316,356640,352324,0,4315.3,0.0
233,2016/3/22,2,Japan,C Channel,4006,360646,356640,0,4073.0,0.0
234,2016/3/23,3,Japan,C Channel,3897,364543,360646,0,3789.3,0.0
235,2016/3/24,4,Japan,C Channel,3465,368008,364543,0,3658.7,0.0
236,2016/3/25,5,Japan,C Channel,3614,371622,368008,0,3894.3,0.0
237,2016/3/26,6,Japan,C Channel,4604,376226,371622,0,4528.7,0.0
238,2016/3/27,7,Japan,C Channel,5368,381594,376226,0,4996.3,0.0
239,2016/3/28,1,Japan,C Channel,5017,386611,381594,0,4989.3,0.0
240,2016/3/29,2,Japan,C Channel,4583,391194,386611,0,4470.0,0.0
241,2016/3/30,3,Japan,C Channel,3810,395004,391194,0,4194.0,0.0
242,2016/3/31,4,Japan,C Channel,4189,399193,395004,0,4439.0,0.0
243,2016/4/1,5,Japan,C Channel,5318,404511,399193,0,5250.7,0.0
244,2016/4/2,6,Japan,C Channel,6245,410756,404511,0,6531.3,0.0
245,2016/4/3,7,Japan,C Channel,8031,418787,410756,0,7665.3,0.0
246,2016/4/4,1,Japan,C Channel,8720,427507,418787,0,8251.3,0.0
247,2016/4/5,2,Japan,C Channel,8003,435510,427507,0,8128.0,0.0
248,2016/4/6,3,Japan,C Channel,7661,443171,435510,0,7652.3,0.0
249,2016/4/7,4,Japan,C Channel,7293,450464,443171,0,7037.0,0.0
250,2016/4/8,5,Japan,C Channel,6157,456621,450464,0,6797.3,0.0
251,2016/4/9,6,Japan,C Channel,6942,463563,456621,0,6880.0,0.0
252,2016/4/10,7,Japan,C Channel,7541,471104,463563,0,6814.7,0.0
253,2016/4/11,1,Japan,C Channel,5961,477065,471104,0,6318.7,0.0
254,2016/4/12,2,Japan,C Channel,5454,482519,477065,0,5673.7,0.0
255,2016/4/13,3,Japan,C Channel,5606,488125,482519,0,5431.0,0.0
256,2016/4/14,4,Japan,C Channel,5233,493358,488125,0,5254.7,0.0
257,2016/4/15,5,Japan,C Channel,4925,498283,493358,0,5371.3,0.0
258,2016/4/16,6,Japan,C Channel,5956,504239,498283,0,5538.7,0.0
259,2016/4/17,7,Japan,C Channel,5735,509974,504239,0,5281.3,0.0
260,2016/4/18,1,Japan,C Channel,4153,514127,509974,0,4554.3,0.0
261,2016/4/19,2,Japan,C Channel,3775,517902,514127,0,3919.7,0.0
262,2016/4/20,3,Japan,C Channel,3831,521733,517902,0,3617.3,0.0
263,2016/4/21,4,Japan,C Channel,3246,524979,521733,0,3304.7,0.0
264,2016/4/22,5,Japan,C Channel,2837,527816,524979,0,3299.3,0.0
265,2016/4/23,6,Japan,C Channel,3815,531631,527816,0,5792.7,0.0
266,2016/4/24,7,Japan,C Channel,10726,542357,531631,0,6187.3,0.0
267,2016/4/25,1,Japan,C Channel,4021,546378,542357,0,6206.3,0.0
268,2016/4/26,2,Japan,C Channel,3872,550250,546378,0,3781.7,0.0
269,2016/4/27,3,Japan,C Channel,3452,553702,550250,0,3407.7,0.0
270,2016/4/28,4,Japan,C Channel,2899,556601,553702,0,3697.7,0.0
271,2016/4/29,5,Japan,C Channel,4742,561343,556601,0,3989.3,0.0
272,2016/4/30,6,Japan,C Channel,4327,565670,561343,0,6038.0,0.0
273,2016/5/1,7,Japan,C Channel,9045,574715,565670,0,6401.3,0.0
274,2016/5/2,1,Japan,C Channel,5832,580547,574715,0,7031.7,0.0
275,2016/5/3,2,Japan,C Channel,6218,586765,580547,0,6884.0,0.0
276,2016/5/4,3,Japan,C Channel,8602,595367,586765,0,7578.0,0.0
277,2016/5/5,4,Japan,C Channel,7914,603281,595367,0,7946.0,0.0
278,2016/5/6,5,Japan,C Channel,7322,610603,603281,0,7746.0,0.0
279,2016/5/7,6,Japan,C Channel,8002,618605,610603,0,7125.3,0.0
280,2016/5/8,7,Japan,C Channel,6052,624657,618605,0,6073.3,0.0
281,2016/5/9,1,Japan,C Channel,4166,628823,624657,0,4889.0,0.0
282,2016/5/10,2,Japan,C Channel,4449,633272,628823,0,4249.7,0.0
283,2016/5/11,3,Japan,C Channel,4134,637406,633272,0,4283.3,0.0
284,2016/5/12,4,Japan,C Channel,4267,641673,637406,0,4231.3,0.0
285,2016/5/13,5,Japan,C Channel,4293,645966,641673,0,4472.0,0.0
286,2016/5/14,6,Japan,C Channel,4856,650822,645966,0,5095.3,0.0
287,2016/5/15,7,Japan,C Channel,6137,656959,650822,0,4864.3,0.0
288,2016/5/16,1,Japan,C Channel,3600,660559,656959,0,4547.7,0.0
289,2016/5/17,2,Japan,C Channel,3906,664465,660559,0,3628.0,0.0
290,2016/5/18,3,Japan,C Channel,3378,667843,664465,0,4067.0,0.0
291,2016/5/19,4,Japan,C Channel,4917,672760,667843,0,4674.3,0.0
292,2016/5/20,5,Japan,C Channel,5728,678488,672760,0,5473.7,0.0
293,2016/5/21,6,Japan,C Channel,5776,684264,678488,0,6430.7,0.0
294,2016/5/22,7,Japan,C Channel,7788,692052,684264,0,6224.3,0.0
295,2016/5/23,1,Japan,C Channel,5109,697161,692052,0,6338.7,0.0
296,2016/5/24,2,Japan,C Channel,6119,703280,697161,0,5971.0,0.0
297,2016/5/25,3,Japan,C Channel,6685,709965,703280,0,6323.7,0.0
298,2016/5/26,4,Japan,C Channel,6167,716132,709965,0,5619.0,0.0
299,2016/5/27,5,Japan,C Channel,4005,720137,716132,0,5242.0,0.0
300,2016/5/28,6,Japan,C Channel,5554,725691,720137,0,5069.0,0.0
301,2016/5/29,7,Japan,C Channel,5648,731339,725691,0,4956.7,0.0
302,2016/5/30,1,Japan,C Channel,3668,735007,731339,0,4281.0,0.0
303,2016/5/31,2,Japan,C Channel,3527,738534,735007,0,4200.7,0.0
304,2016/6/1,3,Japan,C Channel,5407,743941,738534,0,4989.0,0.0
305,2016/6/2,4,Japan,C Channel,6033,749974,743941,0,6365.0,0.0
306,2016/6/3,5,Japan,C Channel,7655,757629,749974,0,9248.7,0.0
307,2016/6/4,6,Japan,C Channel,14058,771687,757629,0,11145.3,0.0
308,2016/6/5,7,Japan,C Channel,11723,783410,771687,0,11772.7,0.0
309,2016/6/6,1,Japan,C Channel,9537,792947,783410,0,10476.0,0.0
310,2016/6/7,2,Japan,C Channel,10168,803115,792947,0,10193.7,0.0
311,2016/6/8,3,Japan,C Channel,10876,813991,803115,0,10322.3,0.0
312,2016/6/9,4,Japan,C Channel,9923,823914,813991,0,10230.0,0.0
313,2016/6/10,5,Japan,C Channel,9891,833805,823914,0,9600.3,0.0
314,2016/6/11,6,Japan,C Channel,8987,842792,833805,0,9633.0,0.0
315,2016/6/12,7,Japan,C Channel,10021,852813,842792,0,9190.3,0.0
316,2016/6/13,1,Japan,C Channel,8563,861376,852813,0,8818.7,0.0
317,2016/6/14,2,Japan,C Channel,7872,869248,861376,0,8126.0,0.0
318,2016/6/15,3,Japan,C Channel,7943,877191,869248,0,8021.3,0.0
319,2016/6/16,4,Japan,C Channel,8249,885440,877191,0,8065.3,0.0
320,2016/6/17,5,Japan,C Channel,8004,893444,885440,0,8263.0,0.0
321,2016/6/18,6,Japan,C Channel,8536,901980,893444,0,8276.7,0.0
322,2016/6/19,7,Japan,C Channel,8290,910270,901980,0,7398.7,0.0
323,2016/6/20,1,Japan,C Channel,5370,915640,910270,0,6522.0,0.0
324,2016/6/21,2,Japan,C Channel,5906,921546,915640,0,5860.7,0.0
325,2016/6/22,3,Japan,C Channel,6306,927852,921546,0,6431.0,0.0
326,2016/6/23,4,Japan,C Channel,7081,934933,927852,0,7135.0,0.0
327,2016/6/24,5,Japan,C Channel,8018,942951,934933,0,7312.3,0.0
328,2016/6/25,6,Japan,C Channel,6838,949789,942951,0,7235.7,0.0
329,2016/6/26,7,Japan,C Channel,6851,956640,949789,0,6341.0,0.0
330,2016/6/27,1,Japan,C Channel,5334,961974,956640,0,5913.7,0.0
331,2016/6/28,2,Japan,C Channel,5556,967530,961974,0,5506.0,0.0
332,2016/6/29,3,Japan,C Channel,5628,973158,967530,0,5546.3,0.0
333,2016/6/30,4,Japan,C Channel,5455,978613,973158,0,5828.0,0.0
334,2016/7/1,5,Japan,C Channel,6401,985014,978613,0,6195.0,0.0
335,2016/7/2,6,Japan,C Channel,6729,991743,985014,0,7486.0,0.0
336,2016/7/3,7,Japan,C Channel,9328,1001071,991743,0,8336.7,0.0
337,2016/7/4,1,Japan,C Channel,8953,1010024,1001071,0,9242.7,0.0
338,2016/7/5,2,Japan,C Channel,9447,1019471,1010024,0,9314.7,0.0
339,2016/7/6,3,Japan,C Channel,9544,1029015,1019471,0,9728.7,0.0
340,2016/7/7,4,Japan,C Channel,10195,1039210,1029015,0,9789.0,0.0
341,2016/7/8,5,Japan,C Channel,9628,1048838,1039210,0,10219.7,0.0
342,2016/7/9,6,Japan,C Channel,10836,1059674,1048838,0,10246.3,0.0
343,2016/7/10,7,Japan,C Channel,10275,1069949,1059674,0,9923.0,0.0
344,2016/7/11,1,Japan,C Channel,8658,1078607,1069949,0,9325.3,0.0
345,2016/7/12,2,Japan,C Channel,9043,1087650,1078607,0,8848.0,0.0
346,2016/7/13,3,Japan,C Channel,8843,1096493,1087650,0,9053.3,0.0
347,2016/7/14,4,Japan,C Channel,9274,1105767,1096493,0,8948.7,0.0
348,2016/7/15,5,Japan,C Channel,8729,1114496,1105767,0,9087.3,0.0
349,2016/7/16,6,Japan,C Channel,9259,1123755,1114496,0,9319.3,0.0
350,2016/7/17,7,Japan,C Channel,9970,1133725,1123755,0,9599.3,0.0
351,2016/7/18,1,Japan,C Channel,9569,1143294,1133725,0,9095.0,0.0
352,2016/7/19,2,Japan,C Channel,7746,1151040,1143294,0,8374.3,0.0
353,2016/7/20,3,Japan,C Channel,7808,1158848,1151040,0,7942.7,0.0
354,2016/7/21,4,Japan,C Channel,8274,1167122,1158848,0,8210.3,0.0
355,2016/7/22,5,Japan,C Channel,8549,1175671,1167122,0,8209.0,0.0
356,2016/7/23,6,Japan,C Channel,7804,1183475,1175671,0,7865.7,0.0
357,2016/7/24,7,Japan,C Channel,7244,1190719,1183475,0,6917.7,0.0
358,2016/7/25,1,Japan,C Channel,5705,1196424,1190719,0,6357.7,0.0
359,2016/7/26,2,Japan,C Channel,6124,1202548,1196424,0,5885.7,0.0
360,2016/7/27,3,Japan,C Channel,5828,1208376,1202548,0,5993.3,0.0
361,2016/7/28,4,Japan,C Channel,6028,1214404,1208376,0,5883.0,0.0
362,2016/7/29,5,Japan,C Channel,5793,1220197,1214404,0,5839.3,0.0
363,2016/7/30,6,Japan,C Channel,5697,1225894,1220197,0,6266.3,0.0
364,2016/7/31,7,Japan,C Channel,7309,1233203,1225894,0,6606.0,0.0
365,2016/8/1,1,Japan,C Channel,6812,1240015,1233203,0,7147.0,0.0
366,2016/8/2,2,Japan,C Channel,7320,1247335,1240015,0,7438.0,0.0
367,2016/8/3,3,Japan,C Channel,8182,1255517,1247335,0,7766.3,0.0
368,2016/8/4,4,Japan,C Channel,7797,1263314,1255517,0,7692.3,0.0
369,2016/8/5,5,Japan,C Channel,7098,1270412,1263314,0,7377.0,0.0
370,2016/8/6,6,Japan,C Channel,7236,1277648,1270412,0,6970.7,0.0
371,2016/8/7,7,Japan,C Channel,6578,1284226,1277648,0,6463.3,0.0
372,2016/8/8,1,Japan,C Channel,5576,1289802,1284226,0,5968.7,0.0
373,2016/8/9,2,Japan,C Channel,5752,1295554,1289802,0,5716.3,0.0
374,2016/8/10,3,Japan,C Channel,5821,1301375,1295554,0,5808.3,0.0
375,2016/8/11,4,Japan,C Channel,5852,1307227,1301375,0,5909.3,0.0
376,2016/8/12,5,Japan,C Channel,6055,1313282,1307227,0,6100.0,0.0
377,2016/8/13,6,Japan,C Channel,6393,1319675,1313282,0,6357.0,0.0
378,2016/8/14,7,Japan,C Channel,6623,1326298,1319675,0,6369.3,0.0
379,2016/8/15,1,Japan,C Channel,6092,1332390,1326298,0,6184.3,0.0
380,2016/8/16,2,Japan,C Channel,5838,1338228,1332390,0,5830.0,0.0
381,2016/8/17,3,Japan,C Channel,5560,1343788,1338228,0,5345.3,0.0
382,2016/8/18,4,Japan,C Channel,4638,1348426,1343788,0,4859.0,0.0
383,2016/8/19,5,Japan,C Channel,4379,1352805,1348426,0,4375.7,0.0
384,2016/8/20,6,Japan,C Channel,4110,1356915,1352805,0,4398.3,0.0
385,2016/8/21,7,Japan,C Channel,4706,1361621,1356915,0,4315.3,0.0
386,2016/8/22,1,Japan,C Channel,4130,1365751,1361621,0,4186.7,0.0
387,2016/8/23,2,Japan,C Channel,3724,1369475,1365751,0,3754.7,0.0
388,2016/8/24,3,Japan,C Channel,3410,1372885,1369475,0,3444.7,0.0
389,2016/8/25,4,Japan,C Channel,3200,1376085,1372885,0,3303.7,0.0
390,2016/8/26,5,Japan,C Channel,3301,1379386,1376085,0,3442.3,0.0
391,2016/8/27,6,Japan,C Channel,3826,1383212,1379386,0,3768.3,0.0
392,2016/8/28,7,Japan,C Channel,4178,1387390,1383212,0,3957.3,0.0
393,2016/8/29,1,Japan,C Channel,3868,1391258,1387390,0,4059.0,0.0
394,2016/8/30,2,Japan,C Channel,4131,1395389,1391258,0,4093.3,0.0
395,2016/8/31,3,Japan,C Channel,4281,1399670,1395389,0,4287.7,0.0
396,2016/9/1,4,Japan,C Channel,4451,1404121,1399670,0,4706.0,0.0
397,2016/9/2,5,Japan,C Channel,5386,1409507,1404121,0,5302.7,0.0
398,2016/9/3,6,Japan,C Channel,6071,1415578,1409507,0,5884.7,0.0
399,2016/9/4,7,Japan,C Channel,6197,1421775,1415578,0,5954.0,0.0
400,2016/9/5,1,Japan,C Channel,5594,1427369,1421775,0,5735.0,0.0
401,2016/9/6,2,Japan,C Channel,5414,1432783,1427369,0,5474.3,0.0
402,2016/9/7,3,Japan,C Channel,5415,1438198,1432783,0,5095.3,0.0
403,2016/9/8,4,Japan,C Channel,4457,1442655,1438198,0,4595.3,0.0
404,2016/9/9,5,Japan,C Channel,3914,1446569,1442655,0,4230.3,0.0
405,2016/9/10,6,Japan,C Channel,4320,1450889,1446569,0,3814.0,0.0
406,2016/9/11,7,Japan,C Channel,3208,1454097,1450889,0,3345.0,0.0
407,2016/9/12,1,Japan,C Channel,2507,1456604,1454097,0,2771.7,0.0
408,2016/9/13,2,Japan,C Channel,2600,1459204,1456604,0,2742.3,0.0
409,2016/9/14,3,Japan,C Channel,3120,1462324,1459204,0,2906.3,0.0
410,2016/9/15,4,Japan,C Channel,2999,1465323,1462324,0,3001.0,0.0
411,2016/9/16,5,Japan,C Channel,2884,1468207,1465323,0,3097.7,0.0
412,2016/9/17,6,Japan,C Channel,3410,1471617,1468207,0,3183.0,0.0
413,2016/9/18,7,Japan,C Channel,3255,1474872,1471617,0,3321.3,0.0
414,2016/9/19,1,Japan,C Channel,3299,1478171,1474872,0,3078.7,0.0
415,2016/9/20,2,Japan,C Channel,2682,1480853,1478171,0,2783.0,0.0
416,2016/9/21,3,Japan,C Channel,2368,1483221,1480853,0,2721.7,0.0
417,2016/9/22,4,Japan,C Channel,3115,1486336,1483221,0,2926.7,0.0
418,2016/9/23,5,Japan,C Channel,3297,1489633,1486336,0,3117.0,0.0
419,2016/9/24,6,Japan,C Channel,2939,1492572,1489633,0,3281.7,0.0
420,2016/9/25,7,Japan,C Channel,3609,1496181,1492572,0,3133.7,0.0
421,2016/9/26,1,Japan,C Channel,2853,1499034,1496181,0,2957.3,0.0
422,2016/9/27,2,Japan,C Channel,2410,1501444,1499034,0,2530.3,0.0
423,2016/9/28,3,Japan,C Channel,2328,1503772,1501444,0,2434.3,0.0
424,2016/9/29,4,Japan,C Channel,2565,1506337,1503772,0,2554.0,0.0
425,2016/9/30,5,Japan,C Channel,2769,1509106,1506337,0,2979.0,0.0
426,2016/10/1,6,Japan,C Channel,3603,1512709,1509106,0,3440.3,0.0
427,2016/10/2,7,Japan,C Channel,3949,1516658,1512709,0,3486.0,0.0
428,2016/10/3,1,Japan,C Channel,2906,1519564,1516658,0,3079.3,0.0
429,2016/10/4,2,Japan,C Channel,2383,1521947,1519564,0,2670.0,0.0
430,2016/10/5,3,Japan,C Channel,2721,1524668,1521947,0,2541.7,0.0
431,2016/10/6,4,Japan,C Channel,2521,1527189,1524668,0,2538.7,0.0
432,2016/10/7,5,Japan,C Channel,2374,1529563,1527189,0,3070.3,0.0
433,2016/10/8,6,Japan,C Channel,4316,1533879,1529563,0,3451.3,0.0
434,2016/10/9,7,Japan,C Channel,3664,1537543,1533879,0,3663.0,0.0
435,2016/10/10,1,Japan,C Channel,3009,1540552,1537543,0,3017.3,0.0
436,2016/10/11,2,Japan,C Channel,2379,1542931,1540552,0,2472.0,0.0
437,2016/10/12,3,Japan,C Channel,2028,1544959,1542931,0,2239.7,0.0
438,2016/10/13,4,Japan,C Channel,2312,1547271,1544959,0,2256.0,0.0
439,2016/10/14,5,Japan,C Channel,2428,1549699,1547271,0,2601.7,0.0
440,2016/10/15,6,Japan,C Channel,3065,1552764,1549699,0,2721.0,0.0
441,2016/10/16,7,Japan,C Channel,2670,1555434,1552764,0,4325.7,29.3
442,2016/10/17,1,Japan,C Channel,7242,1562676,1555434,88,9234.3,63.7
443,2016/10/18,2,Japan,C Channel,17791,1580467,1562676,103,14337.3,102.7
444,2016/10/19,3,Japan,C Channel,17979,1598446,1580467,117,19056.7,94.7
445,2016/10/20,4,Japan,C Channel,21400,1619846,1598446,64,20943.0,87.3
446,2016/10/21,5,Japan,C Channel,23450,1643296,1619846,81,25265.7,86.3
447,2016/10/22,6,Japan,C Channel,30947,1674243,1643296,114,26612.0,100.0
448,2016/10/23,7,Japan,C Channel,25439,1699682,1674243,105,25582.0,108.7
449,2016/10/24,1,Japan,C Channel,20360,1720042,1699682,107,22285.7,103.3
450,2016/10/25,2,Japan,C Channel,21058,1741100,1720042,98,21262.0,91.0
451,2016/10/26,3,Japan,C Channel,22368,1763468,1741100,68,20955.7,83.0
452,2016/10/27,4,Japan,C Channel,19441,1782909,1763468,83,20248.3,77.7
453,2016/10/28,5,Japan,C Channel,18936,1801845,1782909,82,18088.0,89.0
454,2016/10/29,6,Japan,C Channel,15887,1817732,1801845,102,16208.0,85.0
455,2016/10/30,7,Japan,C Channel,13801,1831533,1817732,71,13057.7,57.7
456,2016/10/31,1,Japan,C Channel,9485,1841018,1831533,0,10869.0,23.7
457,2016/11/1,2,Japan,C Channel,9321,1850339,1841018,0,9491.3,0.0
458,2016/11/2,3,Japan,C Channel,9668,1860007,1850339,0,9396.7,0.0
459,2016/11/3,4,Japan,C Channel,9201,1869208,1860007,0,9666.0,0.0
460,2016/11/4,5,Japan,C Channel,10129,1879337,1869208,0,9386.0,0.0
461,2016/11/5,6,Japan,C Channel,8828,1888165,1879337,0,8893.0,0.0
462,2016/11/6,7,Japan,C Channel,7722,1895887,1888165,0,7406.7,0.0
463,2016/11/7,1,Japan,C Channel,5670,1901557,1895887,0,6341.3,0.0
464,2016/11/8,2,Japan,C Channel,5632,1907189,1901557,0,5655.3,0.0
465,2016/11/9,3,Japan,C Channel,5664,1912853,1907189,0,5485.3,0.0
466,2016/11/10,4,Japan,C Channel,5160,1918013,1912853,0,5172.7,0.0
467,2016/11/11,5,Japan,C Channel,4694,1922707,1918013,0,5760.7,0.0
468,2016/11/12,6,Japan,C Channel,7428,1930135,1922707,0,6874.3,0.0
469,2016/11/13,7,Japan,C Channel,8501,1938636,1930135,0,7905.7,4.0
470,2016/11/14,1,Japan,C Channel,7788,1946424,1938636,12,8261.3,4.0
471,2016/11/15,2,Japan,C Channel,8495,1954919,1946424,0,7599.7,4.0
472,2016/11/16,3,Japan,C Channel,6516,1961435,1954919,0,7522.3,0.0
473,2016/11/17,4,Japan,C Channel,7556,1968991,1961435,0,7028.7,0.0
474,2016/11/18,5,Japan,C Channel,7014,1976005,1968991,0,7244.3,0.0
475,2016/11/19,6,Japan,C Channel,7163,1983168,1976005,0,6802.3,0.0
476,2016/11/20,7,Japan,C Channel,6230,1989398,1983168,0,5916.3,0.0
477,2016/11/21,1,Japan,C Channel,4356,1993754,1989398,0,5157.0,0.0
478,2016/11/22,2,Japan,C Channel,4885,1998639,1993754,0,4647.0,0.0
479,2016/11/23,3,Japan,C Channel,4700,2003339,1998639,0,4548.0,0.0
480,2016/11/24,4,Japan,C Channel,4059,2007398,2003339,0,4060.0,0.0
481,2016/11/25,5,Japan,C Channel,3421,2010819,2007398,0,3965.0,0.0
482,2016/11/26,6,Japan,C Channel,4415,2015234,2010819,0,4432.0,0.0
483,2016/11/27,7,Japan,C Channel,5460,2020694,2015234,0,4674.3,0.0
484,2016/11/28,1,Japan,C Channel,4148,2024842,2020694,0,4667.3,0.0
485,2016/11/29,2,Japan,C Channel,4394,2029236,2024842,0,4306.7,0.0
486,2016/11/30,3,Japan,C Channel,4378,2033614,2029236,0,4521.3,0.0
487,2016/12/1,4,Japan,C Channel,4792,2038406,2033614,0,4722.3,0.0
488,2016/12/2,5,Japan,C Channel,4997,2043403,2038406,0,4985.0,0.0
489,2016/12/3,6,Japan,C Channel,5166,2048569,2043403,0,4979.3,0.0
490,2016/12/4,7,Japan,C Channel,4775,2053344,2048569,0,4723.3,0.0
491,2016/12/5,1,Japan,C Channel,4229,2057573,2053344,0,4293.7,0.0
492,2016/12/6,2,Japan,C Channel,3877,2061450,2057573,0,4095.3,0.0
493,2016/12/7,3,Japan,C Channel,4180,2065630,2061450,0,4262.7,0.0
494,2016/12/8,4,Japan,C Channel,4731,2070361,2065630,0,4534.7,0.0
495,2016/12/9,5,Japan,C Channel,4693,2075054,2070361,0,4995.3,0.0
496,2016/12/10,6,Japan,C Channel,5562,2080616,2075054,0,5147.0,0.0
497,2016/12/11,7,Japan,C Channel,5186,2085802,2080616,0,5055.7,0.0
498,2016/12/12,1,Japan,C Channel,4419,2090221,2085802,0,4548.0,0.0
499,2016/12/13,2,Japan,C Channel,4039,2094260,2090221,0,4143.0,0.0
500,2016/12/14,3,Japan,C Channel,3971,2098231,2094260,0,3939.3,0.0
501,2016/12/15,4,Japan,C Channel,3808,2102039,2098231,0,3781.3,0.0
502,2016/12/16,5,Japan,C Channel,3565,2105604,2102039,0,3863.0,0.0
503,2016/12/17,6,Japan,C Channel,4216,2109820,2105604,0,3887.3,0.0
504,2016/12/18,7,Japan,C Channel,3881,2113701,2109820,0,3701.3,0.0
505,2016/12/19,1,Japan,C Channel,3007,2116708,2113701,0,3279.7,0.0
506,2016/12/20,2,Japan,C Channel,2951,2119659,2116708,0,2945.3,0.0
507,2016/12/21,3,Japan,C Channel,2878,2122537,2119659,0,2999.0,0.0
508,2016/12/22,4,Japan,C Channel,3168,2125705,2122537,0,3120.3,0.0
509,2016/12/23,5,Japan,C Channel,3315,2129020,2125705,0,3012.7,0.0
510,2016/12/24,6,Japan,C Channel,2555,2131575,2129020,0,2798.0,0.0
511,2016/12/25,7,Japan,C Channel,2524,2134099,2131575,0,2608.7,0.0
512,2016/12/26,1,Japan,C Channel,2747,2136846,2134099,0,2942.0,0.0
513,2016/12/27,2,Japan,C Channel,3555,2140401,2136846,0,3267.0,0.0
514,2016/12/28,3,Japan,C Channel,3499,2143900,2140401,0,3584.3,0.0
515,2016/12/29,4,Japan,C Channel,3699,2147599,2143900,0,3757.3,0.0
516,2016/12/30,5,Japan,C Channel,4074,2151673,2147599,0,3530.7,0.0
517,2016/12/31,6,Japan,C Channel,2819,2154492,2151673,0,3524.0,0.0
518,2017/1/1,7,Japan,C Channel,3679,2158171,2154492,0,3879.0,0.0
519,2017/1/2,1,Japan,C Channel,5139,2163310,2158171,0,4638.3,0.0
520,2017/1/3,2,Japan,C Channel,5097,2168407,2163310,0,4975.0,0.0
521,2017/1/4,3,Japan,C Channel,4689,2173096,2168407,0,4647.0,0.0
522,2017/1/5,4,Japan,C Channel,4155,2177251,2173096,0,4459.7,0.0
523,2017/1/6,5,Japan,C Channel,4535,2181786,2177251,0,4344.0,0.0
524,2017/1/7,6,Japan,C Channel,4342,2186128,2181786,0,4845.7,0.0
525,2017/1/8,7,Japan,C Channel,5660,2191788,2186128,0,5078.7,0.0
526,2017/1/9,1,Japan,C Channel,5234,2197022,2191788,0,5052.0,0.0
527,2017/1/10,2,Japan,C Channel,4262,2201284,2197022,0,4452.0,0.0
528,2017/1/11,3,Japan,C Channel,3860,2205144,2201284,0,4041.0,0.0
529,2017/1/12,4,Japan,C Channel,4001,2209145,2205144,0,3975.0,0.0
530,2017/1/13,5,Japan,C Channel,4064,2213209,2209145,0,3887.0,0.0
531,2017/1/14,6,Japan,C Channel,3596,2216805,2213209,0,4087.0,0.0
532,2017/1/15,7,Japan,C Channel,4601,2221406,2216805,0,4378.7,0.0
533,2017/1/16,1,Japan,C Channel,4939,2226345,2221406,0,5056.3,0.0
534,2017/1/17,2,Japan,C Channel,5629,2231974,2226345,0,5819.0,0.0
535,2017/1/18,3,Japan,C Channel,6889,2238863,2231974,0,6661.7,0.0
536,2017/1/19,4,Japan,C Channel,7467,2246330,2238863,0,6747.3,0.0
537,2017/1/20,5,Japan,C Channel,5886,2252216,2246330,0,6404.3,0.0
538,2017/1/21,6,Japan,C Channel,5860,2258076,2252216,0,6203.0,0.0
539,2017/1/22,7,Japan,C Channel,6863,2264939,2258076,0,5977.3,0.0
540,2017/1/23,1,Japan,C Channel,5209,2270148,2264939,0,5702.7,0.0
541,2017/1/24,2,Japan,C Channel,5036,2275184,2270148,0,4999.3,0.0
542,2017/1/25,3,Japan,C Channel,4753,2279937,2275184,0,4569.3,0.0
543,2017/1/26,4,Japan,C Channel,3919,2283856,2279937,0,4161.7,0.0
544,2017/1/27,5,Japan,C Channel,3813,2287669,2283856,0,4136.7,0.0
545,2017/1/28,6,Japan,C Channel,4678,2292347,2287669,0,4627.7,0.0
546,2017/1/29,7,Japan,C Channel,5392,2297739,2292347,0,4790.0,0.0
547,2017/1/30,1,Japan,C Channel,4300,2302039,2297739,0,4642.3,0.0
548,2017/1/31,2,Japan,C Channel,4235,2306274,2302039,0,4377.7,0.0
549,2017/2/1,3,Japan,C Channel,4598,2310872,2306274,0,3945.3,0.0
550,2017/2/2,4,Japan,C Channel,3003,2313875,2310872,0,4082.7,0.0
551,2017/2/3,5,Japan,C Channel,4647,2318522,2313875,0,4077.7,0.0
552,2017/2/4,6,Japan,C Channel,4583,2323105,2318522,0,4913.0,0.0
553,2017/2/5,7,Japan,C Channel,5509,2328614,2323105,0,4717.0,0.0
554,2017/2/6,1,Japan,C Channel,4059,2332673,2328614,0,4681.7,0.0
555,2017/2/7,2,Japan,C Channel,4477,2337150,2332673,0,5504.0,0.0
556,2017/2/8,3,Japan,C Channel,7976,2345126,2337150,0,5744.0,0.0
557,2017/2/9,4,Japan,C Channel,4779,2349905,2345126,0,5994.3,0.0
558,2017/2/10,5,Japan,C Channel,5228,2355133,2349905,0,5062.7,0.0
559,2017/2/11,6,Japan,C Channel,5181,2360314,2355133,0,5246.0,0.0
560,2017/2/12,7,Japan,C Channel,5329,2365643,2360314,0,4778.7,0.0
561,2017/2/13,1,Japan,C Channel,3826,2369469,2365643,0,4330.3,0.0
562,2017/2/14,2,Japan,C Channel,3836,2373305,2369469,0,3787.7,0.0
563,2017/2/15,3,Japan,C Channel,3701,2377006,2373305,0,3701.7,0.0
564,2017/2/16,4,Japan,C Channel,3568,2380574,2377006,0,3784.0,0.0
565,2017/2/17,5,Japan,C Channel,4083,2384657,2380574,0,3932.7,0.0
566,2017/2/18,6,Japan,C Channel,4147,2388804,2384657,0,4600.7,0.0
567,2017/2/19,7,Japan,C Channel,5572,2394376,2388804,0,4936.3,0.0
568,2017/2/20,1,Japan,C Channel,5090,2399466,2394376,0,5186.0,0.0
569,2017/2/21,2,Japan,C Channel,4896,2404362,2399466,0,4887.0,0.0
570,2017/2/22,3,Japan,C Channel,4675,2409037,2404362,0,5024.0,0.0
571,2017/2/23,4,Japan,C Channel,5501,2414538,2409037,0,4993.3,0.0
572,2017/2/24,5,Japan,C Channel,4804,2419342,2414538,0,4874.0,0.0
573,2017/2/25,6,Japan,C Channel,4317,2423659,2419342,0,4243.3,0.0
574,2017/2/26,7,Japan,C Channel,3609,2427268,2423659,0,3897.7,0.0
575,2017/2/27,1,Japan,C Channel,3767,2431035,2427268,0,3552.3,0.0
576,2017/2/28,2,Japan,C Channel,3281,2434316,2431035,0,3513.3,0.0
577,2017/3/1,3,Japan,C Channel,3492,2437808,2434316,0,3943.7,0.0
578,2017/3/2,4,Japan,C Channel,5058,2442866,2437808,0,4292.0,0.0
579,2017/3/3,5,Japan,C Channel,4326,2447192,2442866,0,4849.7,0.0
580,2017/3/4,6,Japan,C Channel,5165,2452357,2447192,0,4659.3,0.0
581,2017/3/5,7,Japan,C Channel,4487,2456844,2452357,0,4583.3,0.0
582,2017/3/6,1,Japan,C Channel,4098,2460942,2456844,0,4258.3,0.0
583,2017/3/7,2,Japan,C Channel,4190,2465132,2460942,0,4295.7,0.0
584,2017/3/8,3,Japan,C Channel,4599,2469731,2465132,0,4508.0,0.0
585,2017/3/9,4,Japan,C Channel,4735,2474466,2469731,0,4738.0,0.0
586,2017/3/10,5,Japan,C Channel,4880,2479346,2474466,0,4979.0,0.0
587,2017/3/11,6,Japan,C Channel,5322,2484668,2479346,0,5524.3,0.0
588,2017/3/12,7,Japan,C Channel,6371,2491039,2484668,0,5881.0,0.0
589,2017/3/13,1,Japan,C Channel,5950,2496989,2491039,0,5612.7,0.0
590,2017/3/14,2,Japan,C Channel,4517,2501506,2496989,0,5026.7,0.0
591,2017/3/15,3,Japan,C Channel,4613,2506119,2501506,0,4336.3,0.0
592,2017/3/16,4,Japan,C Channel,3879,2509998,2506119,0,4059.7,0.0
593,2017/3/17,5,Japan,C Channel,3687,2513685,2509998,0,3730.0,0.0
594,2017/3/18,6,Japan,C Channel,3624,2517309,2513685,0,3706.3,0.0
595,2017/3/19,7,Japan,C Channel,3808,2521117,2517309,0,3702.3,0.0
596,2017/3/20,1,Japan,C Channel,3675,2524792,2521117,0,3694.3,0.0
597,2017/3/21,2,Japan,C Channel,3600,2528392,2524792,0,3545.3,0.0
598,2017/3/22,3,Japan,C Channel,3361,2531753,2528392,0,3446.0,0.0
599,2017/3/23,4,Japan,C Channel,3377,2535130,2531753,0,3308.7,0.0
600,2017/3/24,5,Japan,C Channel,3188,2538318,2535130,0,3376.0,0.0
601,2017/3/25,6,Japan,C Channel,3563,2541881,2538318,0,3451.3,0.0
602,2017/3/26,7,Japan,C Channel,3603,2545484,2541881,0,3627.7,0.0
603,2017/3/27,1,Japan,C Channel,3717,2549201,2545484,0,3824.7,0.0
604,2017/3/28,2,Japan,C Channel,4154,2553355,2549201,0,4035.0,0.0
605,2017/3/29,3,Japan,C Channel,4234,2557589,2553355,0,4127.3,0.0
606,2017/3/30,4,Japan,C Channel,3994,2561583,2557589,0,3968.0,0.0
607,2017/3/31,5,Japan,C Channel,3676,2565259,2561583,0,4279.3,0.0
608,2017/4/1,6,Japan,C Channel,5168,2570427,2565259,0,4960.7,0.0
609,2017/4/2,7,Japan,C Channel,6038,2576465,2570427,0,5540.3,0.0
610,2017/4/3,1,Japan,C Channel,5415,2581880,2576465,0,5655.0,0.0
611,2017/4/4,2,Japan,C Channel,5512,2587392,2581880,0,5120.3,0.0
612,2017/4/5,3,Japan,C Channel,4434,2591826,2587392,0,4760.0,0.0
613,2017/4/6,4,Japan,C Channel,4334,2596160,2591826,0,4396.0,0.0
614,2017/4/7,5,Japan,C Channel,4420,2600580,2596160,0,4604.7,0.0
615,2017/4/8,6,Japan,C Channel,5060,2605640,2600580,0,5184.7,0.0
616,2017/4/9,7,Japan,C Channel,6074,2611714,2605640,0,5156.7,0.0
617,2017/4/10,1,Japan,C Channel,4336,2616050,2611714,0,5118.3,0.0
618,2017/4/11,2,Japan,C Channel,4945,2620995,2616050,0,4507.3,0.0
619,2017/4/12,3,Japan,C Channel,4241,2625236,2620995,0,4407.7,0.0
620,2017/4/13,4,Japan,C Channel,4037,2629273,2625236,0,4027.7,0.0
621,2017/4/14,5,Japan,C Channel,3805,2633078,2629273,0,4129.3,0.0
622,2017/4/15,6,Japan,C Channel,4546,2637624,2633078,0,4826.0,0.0
623,2017/4/16,7,Japan,C Channel,6127,2643751,2637624,0,4827.3,0.0
624,2017/4/17,1,Japan,C Channel,3809,2647560,2643751,0,4447.3,0.0
625,2017/4/18,2,Japan,C Channel,3406,2650966,2647560,0,3475.0,0.0
626,2017/4/19,3,Japan,C Channel,3210,2654176,2650966,0,3365.3,0.0
627,2017/4/20,4,Japan,C Channel,3480,2657656,2654176,0,3409.3,0.0
628,2017/4/21,5,Japan,C Channel,3538,2661194,2657656,0,3748.0,0.0
629,2017/4/22,6,Japan,C Channel,4226,2665420,2661194,0,4084.7,0.0
630,2017/4/23,7,Japan,C Channel,4490,2669910,2665420,0,4054.0,0.0
631,2017/4/24,1,Japan,C Channel,3446,2673356,2669910,0,3697.0,0.0
632,2017/4/25,2,Japan,C Channel,3155,2676511,2673356,0,3161.7,0.0
633,2017/4/26,3,Japan,C Channel,2884,2679395,2676511,0,3430.7,0.0
634,2017/4/27,4,Japan,C Channel,4253,2683648,2679395,0,3482.7,0.0
635,2017/4/28,5,Japan,C Channel,3311,2686959,2683648,0,3784.7,0.0
636,2017/4/29,6,Japan,C Channel,3790,2690749,2686959,0,3576.3,0.0
637,2017/4/30,7,Japan,C Channel,3628,2694377,2690749,0,3950.0,0.0
638,2017/5/1,1,Japan,C Channel,4432,2698809,2694377,0,4088.0,0.0
639,2017/5/2,2,Japan,C Channel,4204,2703013,2698809,0,4598.0,0.0
640,2017/5/3,3,Japan,C Channel,5158,2708171,2703013,0,4395.7,0.0
641,2017/5/4,4,Japan,C Channel,3825,2711996,2708171,0,4516.3,0.0
642,2017/5/5,5,Japan,C Channel,4566,2716562,2711996,0,4766.7,0.0
643,2017/5/6,6,Japan,C Channel,5909,2722471,2716562,0,5065.0,0.0
644,2017/5/7,7,Japan,C Channel,4720,2727191,2722471,0,4708.0,0.0
645,2017/5/8,1,Japan,C Channel,3495,2730686,2727191,0,3938.7,0.0
646,2017/5/9,2,Japan,C Channel,3601,2734287,2730686,0,3534.0,0.0
647,2017/5/10,3,Japan,C Channel,3506,2737793,2734287,0,3470.7,0.0
648,2017/5/11,4,Japan,C Channel,3305,2741098,2737793,0,3457.3,0.0
649,2017/5/12,5,Japan,C Channel,3561,2744659,2741098,0,3618.3,0.0
650,2017/5/13,6,Japan,C Channel,3989,2748648,2744659,0,3889.0,0.0
651,2017/5/14,7,Japan,C Channel,4117,2752765,2748648,0,3828.3,0.0
652,2017/5/15,1,Japan,C Channel,3379,2756144,2752765,0,3701.7,0.0
653,2017/5/16,2,Japan,C Channel,3609,2759753,2756144,0,3453.7,0.0
654,2017/5/17,3,Japan,C Channel,3373,2763126,2759753,0,3235.3,0.0
655,2017/5/18,4,Japan,C Channel,2724,2765850,2763126,0,2953.7,0.0
656,2017/5/19,5,Japan,C Channel,2764,2768614,2765850,0,2977.3,0.0
657,2017/5/20,6,Japan,C Channel,3444,2772058,2768614,0,3143.7,0.0
658,2017/5/21,7,Japan,C Channel,3223,2775281,2772058,0,3194.3,0.0
659,2017/5/22,1,Japan,C Channel,2916,2778197,2775281,0,3271.0,0.0
660,2017/5/23,2,Japan,C Channel,3674,2781871,2778197,0,3473.0,0.0
661,2017/5/24,3,Japan,C Channel,3829,2785700,2781871,0,3931.3,0.0
662,2017/5/25,4,Japan,C Channel,4291,2789991,2785700,0,4250.3,0.0
663,2017/5/26,5,Japan,C Channel,4631,2794622,2789991,0,4774.0,0.0
664,2017/5/27,6,Japan,C Channel,5400,2800022,2794622,0,5085.0,0.0
665,2017/5/28,7,Japan,C Channel,5224,2805246,2800022,0,5013.3,0.0
666,2017/5/29,1,Japan,C Channel,4416,2809662,2805246,0,4680.3,0.0
667,2017/5/30,2,Japan,C Channel,4401,2814063,2809662,0,4364.0,0.0
668,2017/5/31,3,Japan,C Channel,4275,2818338,2814063,0,4422.0,0.0
669,2017/6/1,4,Japan,C Channel,4590,2822928,2818338,0,4538.7,0.0
670,2017/6/2,5,Japan,C Channel,4751,2827679,2822928,0,4847.0,0.0
671,2017/6/3,6,Japan,C Channel,5200,2832879,2827679,0,4999.3,0.0
672,2017/6/4,7,Japan,C Channel,5047,2837926,2832879,0,4798.3,0.0
673,2017/6/5,1,Japan,C Channel,4148,2842074,2837926,0,4444.7,0.0
674,2017/6/6,2,Japan,C Channel,4139,2846213,2842074,0,4244.7,0.0
675,2017/6/7,3,Japan,C Channel,4447,2850660,2846213,0,4262.7,0.0
676,2017/6/8,4,Japan,C Channel,4202,2854862,2850660,0,4193.0,0.0
677,2017/6/9,5,Japan,C Channel,3930,2858792,2854862,0,4134.3,0.0
678,2017/6/10,6,Japan,C Channel,4271,2863063,2858792,0,4397.3,0.0
679,2017/6/11,7,Japan,C Channel,4991,2868054,2863063,0,4353.0,0.0
680,2017/6/12,1,Japan,C Channel,3797,2871851,2868054,0,4134.0,0.0
681,2017/6/13,2,Japan,C Channel,3614,2875465,2871851,0,3564.0,0.0
682,2017/6/14,3,Japan,C Channel,3281,2878746,2875465,0,3437.7,0.0
683,2017/6/15,4,Japan,C Channel,3418,2882164,2878746,0,3617.3,0.0
684,2017/6/16,5,Japan,C Channel,4153,2886317,2882164,0,4032.7,0.0
685,2017/6/17,6,Japan,C Channel,4527,2890844,2886317,0,4377.3,0.0
686,2017/6/18,7,Japan,C Channel,4452,2895296,2890844,0,4247.3,0.0
687,2017/6/19,1,Japan,C Channel,3763,2899059,2895296,0,3959.0,0.0
688,2017/6/20,2,Japan,C Channel,3662,2902721,2899059,0,3719.3,0.0
689,2017/6/21,3,Japan,C Channel,3733,2906454,2902721,0,3688.3,0.0
690,2017/6/22,4,Japan,C Channel,3670,2910124,2906454,0,3645.0,0.0
691,2017/6/23,5,Japan,C Channel,3532,2913656,2910124,0,3766.3,0.0
692,2017/6/24,6,Japan,C Channel,4097,2917753,2913656,0,4009.3,0.0
693,2017/6/25,7,Japan,C Channel,4399,2922152,2917753,0,3929.3,0.0
694,2017/6/26,1,Japan,C Channel,3292,2925444,2922152,0,3565.7,0.0
695,2017/6/27,2,Japan,C Channel,3006,2928450,2925444,0,3341.7,0.0
696,2017/6/28,3,Japan,C Channel,3727,2932177,2928450,0,3539.0,0.0
697,2017/6/29,4,Japan,C Channel,3884,2936061,2932177,0,3788.7,0.0
698,2017/6/30,5,Japan,C Channel,3755,2939816,2936061,0,3935.0,0.0
699,2017/7/1,6,Japan,C Channel,4166,2943982,2939816,0,3989.0,0.0
700,2017/7/2,7,Japan,C Channel,4046,2948028,2943982,0,3847.3,0.0
701,2017/7/3,1,Japan,C Channel,3330,2951358,2948028,0,3693.3,0.0
702,2017/7/4,2,Japan,C Channel,3704,2955062,2951358,0,3543.3,0.0
703,2017/7/5,3,Japan,C Channel,3596,2958658,2955062,0,3603.7,0.0
704,2017/7/6,4,Japan,C Channel,3511,2962169,2958658,0,3603.0,0.0
705,2017/7/7,5,Japan,C Channel,3702,2965871,2962169,0,3751.0,0.0
706,2017/7/8,6,Japan,C Channel,4040,2969911,2965871,0,4117.3,0.0
707,2017/7/9,7,Japan,C Channel,4610,2974521,2969911,0,4087.7,0.0
708,2017/7/10,1,Japan,C Channel,3613,2978134,2974521,0,4141.7,0.0
709,2017/7/11,2,Japan,C Channel,4202,2982336,2978134,0,3913.3,0.0
710,2017/7/12,3,Japan,C Channel,3925,2986261,2982336,0,4084.7,0.0
711,2017/7/13,4,Japan,C Channel,4127,2990388,2986261,0,3958.7,0.0
712,2017/7/14,5,Japan,C Channel,3824,2994212,2990388,0,4118.3,0.0
713,2017/7/15,6,Japan,C Channel,4404,2998616,2994212,0,4364.3,0.0
714,2017/7/16,7,Japan,C Channel,4865,3003481,2998616,0,4698.0,0.0
715,2017/7/17,1,Japan,C Channel,4825,3008306,3003481,0,4503.7,0.0
716,2017/7/18,2,Japan,C Channel,3821,3012127,3008306,0,4104.0,0.0
717,2017/7/19,3,Japan,C Channel,3666,3015793,3012127,0,3569.7,0.0
718,2017/7/20,4,Japan,C Channel,3222,3019015,3015793,0,3353.7,0.0
719,2017/7/21,5,Japan,C Channel,3173,3022188,3019015,0,3259.0,0.0
720,2017/7/22,6,Japan,C Channel,3382,3025570,3022188,0,3342.7,0.0
721,2017/7/23,7,Japan,C Channel,3473,3029043,3025570,0,3194.7,0.0
722,2017/7/24,1,Japan,C Channel,2729,3031772,3029043,0,2988.7,0.0
723,2017/7/25,2,Japan,C Channel,2764,3034536,3031772,0,2833.7,0.0
724,2017/7/26,3,Japan,C Channel,3008,3037544,3034536,0,2892.3,0.0
725,2017/7/27,4,Japan,C Channel,2905,3040449,3037544,0,2903.3,0.0
726,2017/7/28,5,Japan,C Channel,2797,3043246,3040449,0,2876.0,0.0
727,2017/7/29,6,Japan,C Channel,2926,3046172,3043246,0,3038.3,0.0
728,2017/7/30,7,Japan,C Channel,3392,3049564,3046172,0,3164.3,0.0
729,2017/7/31,1,Japan,C Channel,3175,3052739,3049564,0,3547.7,0.0
730,2017/8/1,2,Japan,C Channel,4076,3056815,3052739,0,3883.7,0.0
731,2017/8/2,3,Japan,C Channel,4400,3061215,3056815,0,4296.7,0.0
732,2017/8/3,4,Japan,C Channel,4414,3065629,3061215,0,4365.0,0.0
733,2017/8/4,5,Japan,C Channel,4281,3069910,3065629,0,4389.7,0.0
734,2017/8/5,6,Japan,C Channel,4474,3074384,3069910,0,4489.3,0.0
735,2017/8/6,7,Japan,C Channel,4713,3079097,3074384,0,4634.7,0.0
736,2017/8/7,1,Japan,C Channel,4717,3083814,3079097,0,4533.7,0.0
737,2017/8/8,2,Japan,C Channel,4171,3087985,3083814,0,4489.0,0.0
738,2017/8/9,3,Japan,C Channel,4579,3092564,3087985,0,4438.7,0.0
739,2017/8/10,4,Japan,C Channel,4566,3097130,3092564,0,4613.7,1.3
740,2017/8/11,5,Japan,C Channel,4696,3101826,3097130,4,4649.3,1.3
741,2017/8/12,6,Japan,C Channel,4686,3106512,3101826,0,4654.7,1.3
742,2017/8/13,7,Japan,C Channel,4582,3111094,3106512,0,4606.3,0.0
743,2017/8/14,1,Japan,C Channel,4551,3115645,3111094,0,4570.0,0.0
744,2017/8/15,2,Japan,C Channel,4577,3120222,3115645,0,4852.3,0.0
745,2017/8/16,3,Japan,C Channel,5429,3125651,3120222,0,5203.3,0.0
746,2017/8/17,4,Japan,C Channel,5604,3131255,3125651,0,6301.7,0.0
747,2017/8/18,5,Japan,C Channel,7872,3139127,3131255,0,6713.7,27.3
748,2017/8/19,6,Japan,C Channel,6665,3145792,3139127,82,7330.3,60.0
749,2017/8/20,7,Japan,C Channel,7454,3153246,3145792,98,7221.0,88.7
750,2017/8/21,1,Japan,C Channel,7544,3160790,3153246,86,10525.3,106.3
751,2017/8/22,2,Japan,C Channel,16578,3177368,3160790,135,12025.7,119.3
752,2017/8/23,3,Japan,C Channel,11955,3189323,3177368,137,13126.0,131.7
753,2017/8/24,4,Japan,C Channel,10845,3200168,3189323,123,10575.3,133.7
754,2017/8/25,5,Japan,C Channel,8926,3209094,3200168,141,10059.3,129.3
755,2017/8/26,6,Japan,C Channel,10407,3219501,3209094,124,9324.7,134.0
756,2017/8/27,7,Japan,C Channel,8641,3228142,3219501,137,8740.3,87.0
757,2017/8/28,1,Japan,C Channel,7173,3235315,3228142,0,7264.7,45.7
758,2017/8/29,2,Japan,C Channel,5980,3241295,3235315,0,6452.3,0.0
759,2017/8/30,3,Japan,C Channel,6204,3247499,3241295,0,5868.7,0.0
760,2017/8/31,4,Japan,C Channel,5422,3252921,3247499,0,5561.0,0.0
761,2017/9/1,5,Japan,C Channel,5057,3257978,3252921,0,4926.7,0.0
762,2017/9/2,6,Japan,C Channel,4301,3262279,3257978,0,4437.0,0.0
763,2017/9/3,7,Japan,C Channel,3953,3266232,3262279,0,3816.0,0.0
764,2017/9/4,1,Japan,C Channel,3194,3269426,3266232,0,3384.3,0.0
765,2017/9/5,2,Japan,C Channel,3006,3272432,3269426,0,2980.7,0.0
766,2017/9/6,3,Japan,C Channel,2742,3275174,3272432,0,2883.0,0.0
767,2017/9/7,4,Japan,C Channel,2901,3278075,3275174,0,2875.7,0.0
768,2017/9/8,5,Japan,C Channel,2984,3281059,3278075,0,2999.7,0.0
769,2017/9/9,6,Japan,C Channel,3114,3284173,3281059,0,3088.0,0.0
770,2017/9/10,7,Japan,C Channel,3166,3287339,3284173,0,2884.3,0.0
771,2017/9/11,1,Japan,C Channel,2373,3289712,3287339,0,2591.7,0.0
772,2017/9/12,2,Japan,C Channel,2236,3291948,3289712,0,2337.7,0.0
773,2017/9/13,3,Japan,C Channel,2404,3294352,3291948,0,2346.3,0.0
774,2017/9/14,4,Japan,C Channel,2399,3296751,3294352,0,2453.7,0.0
775,2017/9/15,5,Japan,C Channel,2558,3299309,3296751,0,2754.3,0.0
776,2017/9/16,6,Japan,C Channel,3306,3302615,3299309,0,3170.0,0.0
777,2017/9/17,7,Japan,C Channel,3646,3306261,3302615,0,3198.3,0.0
778,2017/9/18,1,Japan,C Channel,2643,3308904,3306261,0,2812.3,0.0
779,2017/9/19,2,Japan,C Channel,2148,3311052,3308904,0,2357.3,0.0
780,2017/9/20,3,Japan,C Channel,2281,3313333,3311052,0,2275.7,0.0
781,2017/9/21,4,Japan,C Channel,2398,3315731,3313333,0,2465.7,0.0
782,2017/9/22,5,Japan,C Channel,2718,3318449,3315731,0,2749.3,0.0
783,2017/9/23,6,Japan,C Channel,3132,3321581,3318449,0,2972.0,0.0
784,2017/9/24,7,Japan,C Channel,3066,3324647,3321581,0,2898.3,0.0
785,2017/9/25,1,Japan,C Channel,2497,3327144,3324647,0,2801.3,0.0
786,2017/9/26,2,Japan,C Channel,2841,3329985,3327144,0,2685.7,0.0
787,2017/9/27,3,Japan,C Channel,2719,3332704,3329985,0,2699.3,0.0
788,2017/9/28,4,Japan,C Channel,2538,3335242,3332704,0,2754.3,0.0
789,2017/9/29,5,Japan,C Channel,3006,3338248,3335242,0,3147.3,0.0
790,2017/9/30,6,Japan,C Channel,3898,3342146,3338248,0,3452.0,0.0
