ID,DATE,WEEK,YEAR,WEEKNUM,Unified_App,TTL,GRP2,TTL_TOTAL,TTL_BEFORE,TTL2,GRP
1,2015/11/30,1,2015,49,KURASHIRU,0,0,0,0,0,0
2,2015/12/1,2,2015,49,KURASHIRU,120,0,120,0,70.3,0.0
3,2015/12/2,3,2015,49,KURASHIRU,91,0,211,120,92.3,0.0
4,2015/12/3,4,2015,49,KURASHIRU,66,0,277,211,74.0,0.0
5,2015/12/4,5,2015,49,KURASHIRU,65,0,342,277,61.7,0.0
6,2015/12/5,6,2015,49,KURASHIRU,54,0,396,342,51.7,0.0
7,2015/12/6,7,2015,49,KURASHIRU,36,0,432,396,38.7,0.0
8,2015/12/7,1,2015,50,KURASHIRU,26,0,458,432,26.0,0.0
9,2015/12/8,2,2015,50,KURASHIRU,16,0,474,458,20.0,0.0
10,2015/12/9,3,2015,50,KURASHIRU,18,0,492,474,18.7,0.0
11,2015/12/10,4,2015,50,KURASHIRU,22,0,514,492,22.3,0.0
12,2015/12/11,5,2015,50,KURASHIRU,27,0,541,514,22.7,0.0
13,2015/12/12,6,2015,50,KURASHIRU,19,0,560,541,24.0,0.0
14,2015/12/13,7,2015,50,KURASHIRU,26,0,586,560,22.0,0.0
15,2015/12/14,1,2015,51,KURASHIRU,21,0,607,586,25.0,0.0
16,2015/12/15,2,2015,51,KURASHIRU,28,0,635,607,23.7,0.0
17,2015/12/16,3,2015,51,KURASHIRU,22,0,657,635,25.3,0.0
18,2015/12/17,4,2015,51,KURASHIRU,26,0,683,657,22.0,0.0
19,2015/12/18,5,2015,51,KURASHIRU,18,0,701,683,19.7,0.0
20,2015/12/19,6,2015,51,KURASHIRU,15,0,716,701,17.3,0.0
21,2015/12/20,7,2015,51,KURASHIRU,19,0,735,716,19.3,0.0
22,2015/12/21,1,2015,52,KURASHIRU,24,0,759,735,21.3,0.0
23,2015/12/22,2,2015,52,KURASHIRU,21,0,780,759,24.0,0.0
24,2015/12/23,3,2015,52,KURASHIRU,27,0,807,780,22.3,0.0
25,2015/12/24,4,2015,52,KURASHIRU,19,0,826,807,21.7,0.0
26,2015/12/25,5,2015,52,KURASHIRU,19,0,845,826,20.0,0.0
27,2015/12/26,6,2015,52,KURASHIRU,22,0,867,845,19.0,0.0
28,2015/12/27,7,2015,52,KURASHIRU,16,0,883,867,19.0,0.0
29,2015/12/28,1,2015,53,KURASHIRU,19,0,902,883,15.7,0.0
30,2015/12/29,2,2015,53,KURASHIRU,12,0,914,902,17.7,0.0
31,2015/12/30,3,2015,53,KURASHIRU,22,0,936,914,21.0,0.0
32,2015/12/31,4,2015,53,KURASHIRU,29,0,965,936,29.7,0.0
33,2016/1/1,5,2016,1,KURASHIRU,38,0,1003,965,29.0,0.0
34,2016/1/2,6,2016,1,KURASHIRU,20,0,1023,1003,33.3,0.0
35,2016/1/3,7,2016,1,KURASHIRU,42,0,1065,1023,32.7,0.0
36,2016/1/4,1,2016,2,KURASHIRU,36,0,1101,1065,36.3,0.0
37,2016/1/5,2,2016,2,KURASHIRU,31,0,1132,1101,30.3,0.0
38,2016/1/6,3,2016,2,KURASHIRU,24,0,1156,1132,26.3,0.0
39,2016/1/7,4,2016,2,KURASHIRU,24,0,1180,1156,23.7,0.0
40,2016/1/8,5,2016,2,KURASHIRU,23,0,1203,1180,25.3,0.0
41,2016/1/9,6,2016,2,KURASHIRU,29,0,1232,1203,24.0,0.0
42,2016/1/10,7,2016,2,KURASHIRU,20,0,1252,1232,23.3,0.0
43,2016/1/11,1,2016,3,KURASHIRU,21,0,1273,1252,24.7,0.0
44,2016/1/12,2,2016,3,KURASHIRU,33,0,1306,1273,38.7,0.0
45,2016/1/13,3,2016,3,KURASHIRU,62,0,1368,1306,43.0,0.0
46,2016/1/14,4,2016,3,KURASHIRU,34,0,1402,1368,41.0,0.0
47,2016/1/15,5,2016,3,KURASHIRU,27,0,1429,1402,31.7,0.0
48,2016/1/16,6,2016,3,KURASHIRU,34,0,1463,1429,58.0,0.0
49,2016/1/17,7,2016,3,KURASHIRU,113,0,1576,1463,80.3,0.0
50,2016/1/18,1,2016,4,KURASHIRU,94,0,1670,1576,92.0,0.0
51,2016/1/19,2,2016,4,KURASHIRU,69,0,1739,1670,78.3,0.0
52,2016/1/20,3,2016,4,KURASHIRU,72,0,1811,1739,68.7,0.0
53,2016/1/21,4,2016,4,KURASHIRU,65,0,1876,1811,69.0,0.0
54,2016/1/22,5,2016,4,KURASHIRU,70,0,1946,1876,112.7,0.0
55,2016/1/23,6,2016,4,KURASHIRU,203,0,2149,1946,169.7,0.0
56,2016/1/24,7,2016,4,KURASHIRU,236,0,2385,2149,196.7,0.0
57,2016/1/25,1,2016,5,KURASHIRU,151,0,2536,2385,173.3,0.0
58,2016/1/26,2,2016,5,KURASHIRU,133,0,2669,2536,126.0,0.0
59,2016/1/27,3,2016,5,KURASHIRU,94,0,2763,2669,103.7,0.0
60,2016/1/28,4,2016,5,KURASHIRU,84,0,2847,2763,94.3,0.0
61,2016/1/29,5,2016,5,KURASHIRU,105,0,2952,2847,98.7,0.0
62,2016/1/30,6,2016,5,KURASHIRU,107,0,3059,2952,106.0,0.0
63,2016/1/31,7,2016,5,KURASHIRU,106,0,3165,3059,96.0,0.0
64,2016/2/1,1,2016,6,KURASHIRU,75,0,3240,3165,81.3,0.0
65,2016/2/2,2,2016,6,KURASHIRU,63,0,3303,3240,74.3,0.0
66,2016/2/3,3,2016,6,KURASHIRU,85,0,3388,3303,95.7,0.0
67,2016/2/4,4,2016,6,KURASHIRU,139,0,3527,3388,101.7,0.0
68,2016/2/5,5,2016,6,KURASHIRU,81,0,3608,3527,91.7,0.0
69,2016/2/6,6,2016,6,KURASHIRU,55,0,3663,3608,64.0,0.0
70,2016/2/7,7,2016,6,KURASHIRU,56,0,3719,3663,50.3,0.0
71,2016/2/8,1,2016,7,KURASHIRU,40,0,3759,3719,47.3,0.0
72,2016/2/9,2,2016,7,KURASHIRU,46,0,3805,3759,46.3,0.0
73,2016/2/10,3,2016,7,KURASHIRU,53,0,3858,3805,52.7,0.0
74,2016/2/11,4,2016,7,KURASHIRU,59,0,3917,3858,59.3,0.0
75,2016/2/12,5,2016,7,KURASHIRU,66,0,3983,3917,62.0,0.0
76,2016/2/13,6,2016,7,KURASHIRU,61,0,4044,3983,70.7,0.0
77,2016/2/14,7,2016,7,KURASHIRU,85,0,4129,4044,65.7,0.0
78,2016/2/15,1,2016,8,KURASHIRU,51,0,4180,4129,60.0,0.0
79,2016/2/16,2,2016,8,KURASHIRU,44,0,4224,4180,50.3,0.0
80,2016/2/17,3,2016,8,KURASHIRU,56,0,4280,4224,47.3,0.0
81,2016/2/18,4,2016,8,KURASHIRU,42,0,4322,4280,47.7,0.0
82,2016/2/19,5,2016,8,KURASHIRU,45,0,4367,4322,43.7,0.0
83,2016/2/20,6,2016,8,KURASHIRU,44,0,4411,4367,41.0,0.0
84,2016/2/21,7,2016,8,KURASHIRU,34,0,4445,4411,37.0,0.0
85,2016/2/22,1,2016,9,KURASHIRU,33,0,4478,4445,30.3,0.0
86,2016/2/23,2,2016,9,KURASHIRU,24,0,4502,4478,31.7,0.0
87,2016/2/24,3,2016,9,KURASHIRU,38,0,4540,4502,29.0,0.0
88,2016/2/25,4,2016,9,KURASHIRU,25,0,4565,4540,46.0,0.0
89,2016/2/26,5,2016,9,KURASHIRU,75,0,4640,4565,60.0,0.0
90,2016/2/27,6,2016,9,KURASHIRU,80,0,4720,4640,72.0,0.0
91,2016/2/28,7,2016,9,KURASHIRU,61,0,4781,4720,59.0,0.0
92,2016/2/29,1,2016,10,KURASHIRU,36,0,4817,4781,45.3,0.0
93,2016/3/1,2,2016,10,KURASHIRU,39,0,4856,4817,37.0,0.0
94,2016/3/2,3,2016,10,KURASHIRU,36,0,4892,4856,34.0,0.0
95,2016/3/3,4,2016,10,KURASHIRU,27,0,4919,4892,50.0,0.0
96,2016/3/4,5,2016,10,KURASHIRU,87,0,5006,4919,54.3,0.0
97,2016/3/5,6,2016,10,KURASHIRU,49,0,5055,5006,62.0,0.0
98,2016/3/6,7,2016,10,KURASHIRU,50,0,5105,5055,47.3,0.0
99,2016/3/7,1,2016,11,KURASHIRU,43,0,5148,5105,46.0,0.0
100,2016/3/8,2,2016,11,KURASHIRU,45,0,5193,5148,37.3,0.0
101,2016/3/9,3,2016,11,KURASHIRU,24,0,5217,5193,270.0,0.0
102,2016/3/10,4,2016,11,KURASHIRU,741,0,5958,5217,385.7,0.0
103,2016/3/11,5,2016,11,KURASHIRU,392,0,6350,5958,421.3,0.0
104,2016/3/12,6,2016,11,KURASHIRU,131,0,6481,6350,213.0,0.0
105,2016/3/13,7,2016,11,KURASHIRU,116,0,6597,6481,108.3,0.0
106,2016/3/14,1,2016,12,KURASHIRU,78,0,6675,6597,83.0,0.0
107,2016/3/15,2,2016,12,KURASHIRU,55,0,6730,6675,88.0,0.0
108,2016/3/16,3,2016,12,KURASHIRU,131,0,6861,6730,116.7,0.0
109,2016/3/17,4,2016,12,KURASHIRU,164,0,7025,6861,177.3,0.0
110,2016/3/18,5,2016,12,KURASHIRU,237,0,7262,7025,207.0,0.0
111,2016/3/19,6,2016,12,KURASHIRU,220,0,7482,7262,303.7,0.0
112,2016/3/20,7,2016,12,KURASHIRU,454,0,7936,7482,412.7,0.0
113,2016/3/21,1,2016,13,KURASHIRU,564,0,8500,7936,488.3,0.0
114,2016/3/22,2,2016,13,KURASHIRU,447,0,8947,8500,454.3,0.0
115,2016/3/23,3,2016,13,KURASHIRU,352,0,9299,8947,342.0,0.0
116,2016/3/24,4,2016,13,KURASHIRU,227,0,9526,9299,261.3,0.0
117,2016/3/25,5,2016,13,KURASHIRU,205,0,9731,9526,199.3,0.0
118,2016/3/26,6,2016,13,KURASHIRU,166,0,9897,9731,196.0,0.0
119,2016/3/27,7,2016,13,KURASHIRU,217,0,10114,9897,211.7,0.0
120,2016/3/28,1,2016,14,KURASHIRU,252,0,10366,10114,234.7,0.0
121,2016/3/29,2,2016,14,KURASHIRU,235,0,10601,10366,233.3,0.0
122,2016/3/30,3,2016,14,KURASHIRU,213,0,10814,10601,220.7,0.0
123,2016/3/31,4,2016,14,KURASHIRU,214,0,11028,10814,208.0,0.0
124,2016/4/1,5,2016,14,KURASHIRU,197,0,11225,11028,204.0,0.0
125,2016/4/2,6,2016,14,KURASHIRU,201,0,11426,11225,223.7,0.0
126,2016/4/3,7,2016,14,KURASHIRU,273,0,11699,11426,230.3,0.0
127,2016/4/4,1,2016,15,KURASHIRU,217,0,11916,11699,232.7,0.0
128,2016/4/5,2,2016,15,KURASHIRU,208,0,12124,11916,203.7,0.0
129,2016/4/6,3,2016,15,KURASHIRU,186,0,12310,12124,194.0,0.0
130,2016/4/7,4,2016,15,KURASHIRU,188,0,12498,12310,178.7,0.0
131,2016/4/8,5,2016,15,KURASHIRU,162,0,12660,12498,175.0,0.0
132,2016/4/9,6,2016,15,KURASHIRU,175,0,12835,12660,217.3,0.0
133,2016/4/10,7,2016,15,KURASHIRU,315,0,13150,12835,230.0,0.0
134,2016/4/11,1,2016,16,KURASHIRU,200,0,13350,13150,226.0,0.0
135,2016/4/12,2,2016,16,KURASHIRU,163,0,13513,13350,173.0,0.0
136,2016/4/13,3,2016,16,KURASHIRU,156,0,13669,13513,215.7,0.0
137,2016/4/14,4,2016,16,KURASHIRU,328,0,13997,13669,370.0,0.0
138,2016/4/15,5,2016,16,KURASHIRU,626,0,14623,13997,558.0,0.0
139,2016/4/16,6,2016,16,KURASHIRU,720,0,15343,14623,750.3,0.0
140,2016/4/17,7,2016,16,KURASHIRU,905,0,16248,15343,750.7,0.0
141,2016/4/18,1,2016,17,KURASHIRU,627,0,16875,16248,704.0,0.0
142,2016/4/19,2,2016,17,KURASHIRU,580,0,17455,16875,589.7,0.0
143,2016/4/20,3,2016,17,KURASHIRU,562,0,18017,17455,571.0,0.0
144,2016/4/21,4,2016,17,KURASHIRU,571,0,18588,18017,527.3,0.0
145,2016/4/22,5,2016,17,KURASHIRU,449,0,19037,18588,548.0,0.0
146,2016/4/23,6,2016,17,KURASHIRU,624,0,19661,19037,570.7,0.0
147,2016/4/24,7,2016,17,KURASHIRU,639,0,20300,19661,551.3,0.0
148,2016/4/25,1,2016,18,KURASHIRU,391,0,20691,20300,467.0,0.0
149,2016/4/26,2,2016,18,KURASHIRU,371,0,21062,20691,467.7,0.0
150,2016/4/27,3,2016,18,KURASHIRU,641,0,21703,21062,510.3,0.0
151,2016/4/28,4,2016,18,KURASHIRU,519,0,22222,21703,654.3,0.0
152,2016/4/29,5,2016,18,KURASHIRU,803,0,23025,22222,627.3,0.0
153,2016/4/30,6,2016,18,KURASHIRU,560,0,23585,23025,576.3,0.0
154,2016/5/1,7,2016,18,KURASHIRU,366,0,23951,23585,376.3,0.0
155,2016/5/2,1,2016,19,KURASHIRU,203,0,24154,23951,261.7,0.0
156,2016/5/3,2,2016,19,KURASHIRU,216,0,24370,24154,307.0,0.0
157,2016/5/4,3,2016,19,KURASHIRU,502,0,24872,24370,351.0,0.0
158,2016/5/5,4,2016,19,KURASHIRU,335,0,25207,24872,405.7,0.0
159,2016/5/6,5,2016,19,KURASHIRU,380,0,25587,25207,371.3,0.0
160,2016/5/7,6,2016,19,KURASHIRU,399,0,25986,25587,468.3,0.0
161,2016/5/8,7,2016,19,KURASHIRU,626,0,26612,25986,547.0,0.0
162,2016/5/9,1,2016,20,KURASHIRU,616,0,27228,26612,605.3,0.0
163,2016/5/10,2,2016,20,KURASHIRU,574,0,27802,27228,553.0,0.0
164,2016/5/11,3,2016,20,KURASHIRU,469,0,28271,27802,487.7,0.0
165,2016/5/12,4,2016,20,KURASHIRU,420,0,28691,28271,414.7,0.0
166,2016/5/13,5,2016,20,KURASHIRU,355,0,29046,28691,390.3,0.0
167,2016/5/14,6,2016,20,KURASHIRU,396,0,29442,29046,382.7,0.0
168,2016/5/15,7,2016,20,KURASHIRU,397,0,29839,29442,359.7,0.0
169,2016/5/16,1,2016,21,KURASHIRU,286,0,30125,29839,330.0,0.0
170,2016/5/17,2,2016,21,KURASHIRU,307,0,30432,30125,355.3,0.0
171,2016/5/18,3,2016,21,KURASHIRU,473,0,30905,30432,436.3,0.0
172,2016/5/19,4,2016,21,KURASHIRU,529,0,31434,30905,514.3,0.0
173,2016/5/20,5,2016,21,KURASHIRU,541,0,31975,31434,487.7,0.0
174,2016/5/21,6,2016,21,KURASHIRU,393,0,32368,31975,568.7,0.0
175,2016/5/22,7,2016,21,KURASHIRU,772,0,33140,32368,794.3,0.0
176,2016/5/23,1,2016,22,KURASHIRU,1218,0,34358,33140,1061.7,0.0
177,2016/5/24,2,2016,22,KURASHIRU,1195,0,35553,34358,1219.7,0.0
178,2016/5/25,3,2016,22,KURASHIRU,1246,0,36799,35553,1706.0,0.0
179,2016/5/26,4,2016,22,KURASHIRU,2677,0,39476,36799,2347.3,0.0
180,2016/5/27,5,2016,22,KURASHIRU,3119,0,42595,39476,2697.7,0.0
181,2016/5/28,6,2016,22,KURASHIRU,2297,0,44892,42595,2834.3,0.0
182,2016/5/29,7,2016,22,KURASHIRU,3087,0,47979,44892,2707.7,0.0
183,2016/5/30,1,2016,23,KURASHIRU,2739,0,50718,47979,3116.7,0.0
184,2016/5/31,2,2016,23,KURASHIRU,3524,0,54242,50718,3203.0,0.0
185,2016/6/1,3,2016,23,KURASHIRU,3346,0,57588,54242,3323.7,0.0
186,2016/6/2,4,2016,23,KURASHIRU,3101,0,60689,57588,3538.7,0.0
187,2016/6/3,5,2016,23,KURASHIRU,4169,0,64858,60689,3857.0,0.0
188,2016/6/4,6,2016,23,KURASHIRU,4301,0,69159,64858,4500.0,0.0
189,2016/6/5,7,2016,23,KURASHIRU,5030,0,74189,69159,4379.3,0.0
190,2016/6/6,1,2016,24,KURASHIRU,3807,0,77996,74189,4318.0,0.0
191,2016/6/7,2,2016,24,KURASHIRU,4117,0,82113,77996,3830.7,0.0
192,2016/6/8,3,2016,24,KURASHIRU,3568,0,85681,82113,3658.0,0.0
193,2016/6/9,4,2016,24,KURASHIRU,3289,0,88970,85681,3312.7,0.0
194,2016/6/10,5,2016,24,KURASHIRU,3081,0,92051,88970,2939.3,0.0
195,2016/6/11,6,2016,24,KURASHIRU,2448,0,94499,92051,2866.7,0.0
196,2016/6/12,7,2016,24,KURASHIRU,3071,0,97570,94499,2956.7,0.0
197,2016/6/13,1,2016,25,KURASHIRU,3351,0,100921,97570,3201.3,0.0
198,2016/6/14,2,2016,25,KURASHIRU,3182,0,104103,100921,3110.3,0.0
199,2016/6/15,3,2016,25,KURASHIRU,2798,0,106901,104103,2837.7,0.0
200,2016/6/16,4,2016,25,KURASHIRU,2533,0,109434,106901,2470.0,0.0
201,2016/6/17,5,2016,25,KURASHIRU,2079,0,111513,109434,2140.7,0.0
202,2016/6/18,6,2016,25,KURASHIRU,1810,0,113323,111513,1879.3,0.0
203,2016/6/19,7,2016,25,KURASHIRU,1749,0,115072,113323,1604.7,0.0
204,2016/6/20,1,2016,26,KURASHIRU,1255,0,116327,115072,1460.7,0.0
205,2016/6/21,2,2016,26,KURASHIRU,1378,0,117705,116327,1331.0,0.0
206,2016/6/22,3,2016,26,KURASHIRU,1360,0,119065,117705,1562.3,0.0
207,2016/6/23,4,2016,26,KURASHIRU,1949,0,121014,119065,1707.7,0.0
208,2016/6/24,5,2016,26,KURASHIRU,1814,0,122828,121014,1871.7,0.0
209,2016/6/25,6,2016,26,KURASHIRU,1852,0,124680,122828,1724.0,0.0
210,2016/6/26,7,2016,26,KURASHIRU,1506,0,126186,124680,1538.0,0.0
211,2016/6/27,1,2016,27,KURASHIRU,1256,0,127442,126186,1448.0,0.0
212,2016/6/28,2,2016,27,KURASHIRU,1582,0,129024,127442,1649.3,0.0
213,2016/6/29,3,2016,27,KURASHIRU,2110,0,131134,129024,1806.0,0.0
214,2016/6/30,4,2016,27,KURASHIRU,1726,0,132860,131134,1810.3,0.0
215,2016/7/1,5,2016,27,KURASHIRU,1595,0,134455,132860,1640.3,0.0
216,2016/7/2,6,2016,27,KURASHIRU,1600,0,136055,134455,1651.3,0.0
217,2016/7/3,7,2016,27,KURASHIRU,1759,0,137814,136055,1638.3,0.0
218,2016/7/4,1,2016,28,KURASHIRU,1556,0,139370,137814,1650.0,0.0
219,2016/7/5,2,2016,28,KURASHIRU,1635,0,141005,139370,1574.3,0.0
220,2016/7/6,3,2016,28,KURASHIRU,1532,0,142537,141005,1576.0,0.0
221,2016/7/7,4,2016,28,KURASHIRU,1561,0,144098,142537,1556.3,0.0
222,2016/7/8,5,2016,28,KURASHIRU,1576,0,145674,144098,1766.0,0.0
223,2016/7/9,6,2016,28,KURASHIRU,2161,0,147835,145674,1885.0,0.0
224,2016/7/10,7,2016,28,KURASHIRU,1918,0,149753,147835,1909.3,0.0
225,2016/7/11,1,2016,29,KURASHIRU,1649,0,151402,149753,1825.0,0.0
226,2016/7/12,2,2016,29,KURASHIRU,1908,0,153310,151402,1831.3,0.0
227,2016/7/13,3,2016,29,KURASHIRU,1937,0,155247,153310,1885.7,0.0
228,2016/7/14,4,2016,29,KURASHIRU,1812,0,157059,155247,3780.7,0.0
229,2016/7/15,5,2016,29,KURASHIRU,7593,0,164652,157059,7270.3,0.0
230,2016/7/16,6,2016,29,KURASHIRU,12406,0,177058,164652,8406.7,0.0
231,2016/7/17,7,2016,29,KURASHIRU,5221,0,182279,177058,6787.0,0.0
232,2016/7/18,1,2016,30,KURASHIRU,2734,0,185013,182279,3264.3,0.0
233,2016/7/19,2,2016,30,KURASHIRU,1838,0,186851,185013,2089.0,0.0
234,2016/7/20,3,2016,30,KURASHIRU,1695,0,188546,186851,1637.0,0.0
235,2016/7/21,4,2016,30,KURASHIRU,1378,0,189924,188546,1463.0,0.0
236,2016/7/22,5,2016,30,KURASHIRU,1316,0,191240,189924,1269.7,0.0
237,2016/7/23,6,2016,30,KURASHIRU,1115,0,192355,191240,1140.7,0.0
238,2016/7/24,7,2016,30,KURASHIRU,991,0,193346,192355,1025.3,0.0
239,2016/7/25,1,2016,31,KURASHIRU,970,0,194316,193346,1013.0,0.0
240,2016/7/26,2,2016,31,KURASHIRU,1078,0,195394,194316,1038.7,0.0
241,2016/7/27,3,2016,31,KURASHIRU,1068,0,196462,195394,1058.0,0.0
242,2016/7/28,4,2016,31,KURASHIRU,1028,0,197490,196462,1035.3,0.0
243,2016/7/29,5,2016,31,KURASHIRU,1010,0,198500,197490,925.7,0.0
244,2016/7/30,6,2016,31,KURASHIRU,739,0,199239,198500,795.3,0.0
245,2016/7/31,7,2016,31,KURASHIRU,637,0,199876,199239,655.3,0.0
246,2016/8/1,1,2016,32,KURASHIRU,590,0,200466,199876,615.0,0.0
247,2016/8/2,2,2016,32,KURASHIRU,618,0,201084,200466,637.0,0.0
248,2016/8/3,3,2016,32,KURASHIRU,703,0,201787,201084,795.3,0.0
249,2016/8/4,4,2016,32,KURASHIRU,1065,0,202852,201787,939.0,0.0
250,2016/8/5,5,2016,32,KURASHIRU,1049,0,203901,202852,1025.7,0.0
251,2016/8/6,6,2016,32,KURASHIRU,963,0,204864,203901,984.3,0.0
252,2016/8/7,7,2016,32,KURASHIRU,941,0,205805,204864,1314.0,0.0
253,2016/8/8,1,2016,33,KURASHIRU,2038,0,207843,205805,3162.0,0.0
254,2016/8/9,2,2016,33,KURASHIRU,6507,0,214350,207843,6327.7,0.0
255,2016/8/10,3,2016,33,KURASHIRU,10438,0,224788,214350,11255.0,0.0
256,2016/8/11,4,2016,33,KURASHIRU,16820,0,241608,224788,14537.0,0.0
257,2016/8/12,5,2016,33,KURASHIRU,16353,0,257961,241608,16608.3,0.0
258,2016/8/13,6,2016,33,KURASHIRU,16652,0,274613,257961,15239.0,0.0
259,2016/8/14,7,2016,33,KURASHIRU,12712,0,287325,274613,13910.0,0.0
260,2016/8/15,1,2016,34,KURASHIRU,12366,0,299691,287325,12471.7,0.0
261,2016/8/16,2,2016,34,KURASHIRU,12337,0,312028,299691,13064.7,0.0
262,2016/8/17,3,2016,34,KURASHIRU,14491,0,326519,312028,13100.0,0.0
263,2016/8/18,4,2016,34,KURASHIRU,12472,0,338991,326519,12775.7,0.0
264,2016/8/19,5,2016,34,KURASHIRU,11364,0,350355,338991,11433.0,0.0
265,2016/8/20,6,2016,34,KURASHIRU,10463,0,360818,350355,10115.7,0.0
266,2016/8/21,7,2016,34,KURASHIRU,8520,0,369338,360818,10044.0,0.0
267,2016/8/22,1,2016,35,KURASHIRU,11149,0,380487,369338,9805.7,0.0
268,2016/8/23,2,2016,35,KURASHIRU,9748,0,390235,380487,10134.3,0.0
269,2016/8/24,3,2016,35,KURASHIRU,9506,0,399741,390235,9540.0,0.0
270,2016/8/25,4,2016,35,KURASHIRU,9366,0,409107,399741,9336.3,0.0
271,2016/8/26,5,2016,35,KURASHIRU,9137,0,418244,409107,8521.0,0.0
272,2016/8/27,6,2016,35,KURASHIRU,7060,0,425304,418244,7236.3,0.0
273,2016/8/28,7,2016,35,KURASHIRU,5512,0,430816,425304,6685.0,0.0
274,2016/8/29,1,2016,36,KURASHIRU,7483,0,438299,430816,6784.0,0.0
275,2016/8/30,2,2016,36,KURASHIRU,7357,0,445656,438299,7862.0,0.0
276,2016/8/31,3,2016,36,KURASHIRU,8746,0,454402,445656,8604.0,0.0
277,2016/9/1,4,2016,36,KURASHIRU,9709,0,464111,454402,9708.7,0.0
278,2016/9/2,5,2016,36,KURASHIRU,10671,0,474782,464111,10677.7,0.0
279,2016/9/3,6,2016,36,KURASHIRU,11653,0,486435,474782,11037.7,0.0
280,2016/9/4,7,2016,36,KURASHIRU,10789,0,497224,486435,11660.7,0.0
281,2016/9/5,1,2016,37,KURASHIRU,12540,0,509764,497224,11626.7,0.0
282,2016/9/6,2,2016,37,KURASHIRU,11551,0,521315,509764,12223.0,0.0
283,2016/9/7,3,2016,37,KURASHIRU,12578,0,533893,521315,12412.7,0.0
284,2016/9/8,4,2016,37,KURASHIRU,13109,0,547002,533893,11633.0,0.0
285,2016/9/9,5,2016,37,KURASHIRU,9212,0,556214,547002,9627.3,0.0
286,2016/9/10,6,2016,37,KURASHIRU,6561,0,562775,556214,7314.7,0.0
287,2016/9/11,7,2016,37,KURASHIRU,6171,0,568946,562775,7920.0,0.0
288,2016/9/12,1,2016,38,KURASHIRU,11028,0,579974,568946,9640.0,0.0
289,2016/9/13,2,2016,38,KURASHIRU,11721,0,591695,579974,11282.0,0.0
290,2016/9/14,3,2016,38,KURASHIRU,11097,0,602792,591695,9311.0,0.0
291,2016/9/15,4,2016,38,KURASHIRU,5115,0,607907,602792,6391.7,0.0
292,2016/9/16,5,2016,38,KURASHIRU,2963,0,610870,607907,3810.7,0.0
293,2016/9/17,6,2016,38,KURASHIRU,3354,0,614224,610870,3571.7,0.0
294,2016/9/18,7,2016,38,KURASHIRU,4398,0,618622,614224,4070.0,0.0
295,2016/9/19,1,2016,39,KURASHIRU,4458,0,623080,618622,5497.3,0.0
296,2016/9/20,2,2016,39,KURASHIRU,7636,0,630716,623080,5899.0,0.0
297,2016/9/21,3,2016,39,KURASHIRU,5603,0,636319,630716,6659.7,0.0
298,2016/9/22,4,2016,39,KURASHIRU,6740,0,643059,636319,6140.3,0.0
299,2016/9/23,5,2016,39,KURASHIRU,6078,0,649137,643059,5722.0,0.0
300,2016/9/24,6,2016,39,KURASHIRU,4348,0,653485,649137,5154.7,0.0
301,2016/9/25,7,2016,39,KURASHIRU,5038,0,658523,653485,4254.3,0.0
302,2016/9/26,1,2016,40,KURASHIRU,3377,0,661900,658523,3528.0,0.0
303,2016/9/27,2,2016,40,KURASHIRU,2169,0,664069,661900,2358.3,0.0
304,2016/9/28,3,2016,40,KURASHIRU,1529,0,665598,664069,1708.7,0.0
305,2016/9/29,4,2016,40,KURASHIRU,1428,0,667026,665598,1343.7,0.0
306,2016/9/30,5,2016,40,KURASHIRU,1074,0,668100,667026,1224.7,0.0
307,2016/10/1,6,2016,40,KURASHIRU,1172,0,669272,668100,1113.7,0.0
308,2016/10/2,7,2016,40,KURASHIRU,1095,0,670367,669272,1079.0,0.0
309,2016/10/3,1,2016,41,KURASHIRU,970,0,671337,670367,1049.7,0.0
310,2016/10/4,2,2016,41,KURASHIRU,1084,0,672421,671337,982.3,0.0
311,2016/10/5,3,2016,41,KURASHIRU,893,0,673314,672421,935.7,0.0
312,2016/10/6,4,2016,41,KURASHIRU,830,0,674144,673314,933.3,0.0
313,2016/10/7,5,2016,41,KURASHIRU,1077,0,675221,674144,1048.3,0.0
314,2016/10/8,6,2016,41,KURASHIRU,1238,0,676459,675221,1100.0,0.0
315,2016/10/9,7,2016,41,KURASHIRU,985,0,677444,676459,1061.7,0.0
316,2016/10/10,1,2016,42,KURASHIRU,962,0,678406,677444,956.3,0.0
317,2016/10/11,2,2016,42,KURASHIRU,922,0,679328,678406,922.7,0.0
318,2016/10/12,3,2016,42,KURASHIRU,884,0,680212,679328,985.7,0.0
319,2016/10/13,4,2016,42,KURASHIRU,1151,0,681363,680212,1054.0,0.0
320,2016/10/14,5,2016,42,KURASHIRU,1127,0,682490,681363,1248.3,0.0
321,2016/10/15,6,2016,42,KURASHIRU,1467,0,683957,682490,1396.0,0.0
322,2016/10/16,7,2016,42,KURASHIRU,1594,0,685551,683957,1460.0,0.0
323,2016/10/17,1,2016,43,KURASHIRU,1319,0,686870,685551,1390.3,0.0
324,2016/10/18,2,2016,43,KURASHIRU,1258,0,688128,686870,1266.0,0.0
325,2016/10/19,3,2016,43,KURASHIRU,1221,0,689349,688128,1276.3,0.0
326,2016/10/20,4,2016,43,KURASHIRU,1350,0,690699,689349,1281.7,0.0
327,2016/10/21,5,2016,43,KURASHIRU,1274,0,691973,690699,1390.3,0.0
328,2016/10/22,6,2016,43,KURASHIRU,1547,0,693520,691973,1306.0,0.0
329,2016/10/23,7,2016,43,KURASHIRU,1097,0,694617,693520,1771.0,0.0
330,2016/10/24,1,2016,44,KURASHIRU,2669,0,697286,694617,3063.0,0.0
331,2016/10/25,2,2016,44,KURASHIRU,5423,0,702709,697286,5161.7,0.0
332,2016/10/26,3,2016,44,KURASHIRU,7393,0,710102,702709,6502.3,0.0
333,2016/10/27,4,2016,44,KURASHIRU,6691,0,716793,710102,7120.3,0.0
334,2016/10/28,5,2016,44,KURASHIRU,7277,0,724070,716793,7122.7,0.0
335,2016/10/29,6,2016,44,KURASHIRU,7400,0,731470,724070,7752.0,0.0
336,2016/10/30,7,2016,44,KURASHIRU,8579,0,740049,731470,7242.0,0.0
337,2016/10/31,1,2016,45,KURASHIRU,5747,0,745796,740049,7021.0,0.0
338,2016/11/1,2,2016,45,KURASHIRU,6737,0,752533,745796,6801.7,0.0
339,2016/11/2,3,2016,45,KURASHIRU,7921,0,760454,752533,7719.7,0.0
340,2016/11/3,4,2016,45,KURASHIRU,8501,0,768955,760454,8520.3,0.0
341,2016/11/4,5,2016,45,KURASHIRU,9139,0,778094,768955,8301.0,0.0
342,2016/11/5,6,2016,45,KURASHIRU,7263,0,785357,778094,7635.0,0.0
343,2016/11/6,7,2016,45,KURASHIRU,6503,0,791860,785357,6522.3,0.0
344,2016/11/7,1,2016,46,KURASHIRU,5801,0,797661,791860,6512.0,0.0
345,2016/11/8,2,2016,46,KURASHIRU,7232,0,804893,797661,6887.3,0.0
346,2016/11/9,3,2016,46,KURASHIRU,7629,0,812522,804893,8338.7,0.0
347,2016/11/10,4,2016,46,KURASHIRU,10155,0,822677,812522,8648.7,0.0
348,2016/11/11,5,2016,46,KURASHIRU,8162,0,830839,822677,8615.7,0.0
349,2016/11/12,6,2016,46,KURASHIRU,7530,0,838369,830839,7395.3,0.0
350,2016/11/13,7,2016,46,KURASHIRU,6494,0,844863,838369,7699.0,0.0
351,2016/11/14,1,2016,47,KURASHIRU,9073,0,853936,844863,9045.3,0.0
352,2016/11/15,2,2016,47,KURASHIRU,11569,0,865505,853936,9835.0,0.0
353,2016/11/16,3,2016,47,KURASHIRU,8863,0,874368,865505,10215.3,0.0
354,2016/11/17,4,2016,47,KURASHIRU,10214,0,884582,874368,9830.3,0.0
355,2016/11/18,5,2016,47,KURASHIRU,10414,0,894996,884582,10109.7,0.0
356,2016/11/19,6,2016,47,KURASHIRU,9701,0,904697,894996,10934.0,0.0
357,2016/11/20,7,2016,47,KURASHIRU,12687,0,917384,904697,11305.0,0.0
358,2016/11/21,1,2016,48,KURASHIRU,11527,0,928911,917384,13291.0,0.0
359,2016/11/22,2,2016,48,KURASHIRU,15659,0,944570,928911,15124.0,0.0
360,2016/11/23,3,2016,48,KURASHIRU,18186,0,962756,944570,17626.0,0.0
361,2016/11/24,4,2016,48,KURASHIRU,19033,0,981789,962756,17560.0,0.0
362,2016/11/25,5,2016,48,KURASHIRU,15461,0,997250,981789,15896.3,0.0
363,2016/11/26,6,2016,48,KURASHIRU,13195,0,1010445,997250,18950.3,0.0
364,2016/11/27,7,2016,48,KURASHIRU,28195,0,1038640,1010445,20704.3,0.0
365,2016/11/28,1,2016,49,KURASHIRU,20723,0,1059363,1038640,23324.7,0.0
366,2016/11/29,2,2016,49,KURASHIRU,21056,0,1080419,1059363,21263.3,0.0
367,2016/11/30,3,2016,49,KURASHIRU,22011,0,1102430,1080419,22487.0,0.0
368,2016/12/1,4,2016,49,KURASHIRU,24394,0,1126824,1102430,23588.0,0.0
369,2016/12/2,5,2016,49,KURASHIRU,24359,0,1151183,1126824,22714.3,0.0
370,2016/12/3,6,2016,49,KURASHIRU,19390,0,1170573,1151183,21311.7,0.0
371,2016/12/4,7,2016,49,KURASHIRU,20186,0,1190759,1170573,17497.3,0.0
372,2016/12/5,1,2016,50,KURASHIRU,12916,0,1203675,1190759,16890.0,0.0
373,2016/12/6,2,2016,50,KURASHIRU,17568,0,1221243,1203675,16554.3,0.0
374,2016/12/7,3,2016,50,KURASHIRU,19179,0,1240422,1221243,18760.0,0.0
375,2016/12/8,4,2016,50,KURASHIRU,19533,0,1259955,1240422,19470.3,0.0
376,2016/12/9,5,2016,50,KURASHIRU,19699,0,1279654,1259955,19966.0,0.0
377,2016/12/10,6,2016,50,KURASHIRU,20666,0,1300320,1279654,18923.3,0.0
378,2016/12/11,7,2016,50,KURASHIRU,16405,0,1316725,1300320,16722.0,0.0
379,2016/12/12,1,2016,51,KURASHIRU,13095,0,1329820,1316725,14663.7,0.0
380,2016/12/13,2,2016,51,KURASHIRU,14491,0,1344311,1329820,13743.0,0.0
381,2016/12/14,3,2016,51,KURASHIRU,13643,0,1357954,1344311,13916.3,0.0
382,2016/12/15,4,2016,51,KURASHIRU,13615,0,1371569,1357954,13167.3,0.0
383,2016/12/16,5,2016,51,KURASHIRU,12244,0,1383813,1371569,12032.7,0.0
384,2016/12/17,6,2016,51,KURASHIRU,10239,0,1394052,1383813,11466.0,0.0
385,2016/12/18,7,2016,51,KURASHIRU,11915,0,1405967,1394052,10401.3,0.0
386,2016/12/19,1,2016,52,KURASHIRU,9050,0,1415017,1405967,9713.3,0.0
387,2016/12/20,2,2016,52,KURASHIRU,8175,0,1423192,1415017,9835.3,0.0
388,2016/12/21,3,2016,52,KURASHIRU,12281,0,1435473,1423192,11512.3,0.0
389,2016/12/22,4,2016,52,KURASHIRU,14081,0,1449554,1435473,12998.0,0.0
390,2016/12/23,5,2016,52,KURASHIRU,12632,0,1462186,1449554,12694.3,0.0
391,2016/12/24,6,2016,52,KURASHIRU,11370,0,1473556,1462186,11588.0,0.0
392,2016/12/25,7,2016,52,KURASHIRU,10762,0,1484318,1473556,11166.7,0.0
393,2016/12/26,1,2016,53,KURASHIRU,11368,0,1495686,1484318,11441.0,0.0
394,2016/12/27,2,2016,53,KURASHIRU,12193,0,1507879,1495686,11400.7,0.0
395,2016/12/28,3,2016,53,KURASHIRU,10641,0,1518520,1507879,11058.0,0.0
396,2016/12/29,4,2016,53,KURASHIRU,10340,0,1528860,1518520,10694.3,0.0
397,2016/12/30,5,2016,53,KURASHIRU,11102,0,1539962,1528860,10046.0,0.0
398,2016/12/31,6,2016,53,KURASHIRU,8696,0,1548658,1539962,10208.3,0.0
399,2017/1/1,7,2017,1,KURASHIRU,10827,0,1559485,1548658,9918.7,0.0
400,2017/1/2,1,2017,2,KURASHIRU,10233,0,1569718,1559485,9725.3,0.0
401,2017/1/3,2,2017,2,KURASHIRU,8116,0,1577834,1569718,9292.0,0.0
402,2017/1/4,3,2017,2,KURASHIRU,9527,0,1587361,1577834,9648.3,0.0
403,2017/1/5,4,2017,2,KURASHIRU,11302,0,1598663,1587361,11206.0,0.0
404,2017/1/6,5,2017,2,KURASHIRU,12789,0,1611452,1598663,11869.3,0.0
405,2017/1/7,6,2017,2,KURASHIRU,11517,0,1622969,1611452,13853.3,0.0
406,2017/1/8,7,2017,2,KURASHIRU,17254,0,1640223,1622969,14559.3,0.0
407,2017/1/9,1,2017,3,KURASHIRU,14907,0,1655130,1640223,15536.3,0.0
408,2017/1/10,2,2017,3,KURASHIRU,14448,0,1669578,1655130,14904.0,0.0
409,2017/1/11,3,2017,3,KURASHIRU,15357,0,1684935,1669578,15310.7,0.0
410,2017/1/12,4,2017,3,KURASHIRU,16127,0,1701062,1684935,16606.7,0.0
411,2017/1/13,5,2017,3,KURASHIRU,18336,0,1719398,1701062,16446.7,0.0
412,2017/1/14,6,2017,3,KURASHIRU,14877,0,1734275,1719398,16550.7,0.0
413,2017/1/15,7,2017,3,KURASHIRU,16439,0,1750714,1734275,16365.7,0.0
414,2017/1/16,1,2017,4,KURASHIRU,17781,0,1768495,1750714,17586.3,0.0
415,2017/1/17,2,2017,4,KURASHIRU,18539,0,1787034,1768495,17896.3,0.0
416,2017/1/18,3,2017,4,KURASHIRU,17369,0,1804403,1787034,18919.3,0.0
417,2017/1/19,4,2017,4,KURASHIRU,20850,0,1825253,1804403,20690.7,0.0
418,2017/1/20,5,2017,4,KURASHIRU,23853,0,1849106,1825253,22240.3,0.0
419,2017/1/21,6,2017,4,KURASHIRU,22018,0,1871124,1849106,22524.3,0.0
420,2017/1/22,7,2017,4,KURASHIRU,21702,0,1892826,1871124,21250.0,0.0
421,2017/1/23,1,2017,5,KURASHIRU,20030,0,1912856,1892826,20718.0,0.0
422,2017/1/24,2,2017,5,KURASHIRU,20422,0,1933278,1912856,20463.0,0.0
423,2017/1/25,3,2017,5,KURASHIRU,20937,0,1954215,1933278,20257.7,0.0
424,2017/1/26,4,2017,5,KURASHIRU,19414,0,1973629,1954215,20107.7,0.0
425,2017/1/27,5,2017,5,KURASHIRU,19972,0,1993601,1973629,21274.7,0.0
426,2017/1/28,6,2017,5,KURASHIRU,24438,0,2018039,1993601,23171.7,0.0
427,2017/1/29,7,2017,5,KURASHIRU,25105,0,2043144,2018039,23795.0,0.0
428,2017/1/30,1,2017,6,KURASHIRU,21842,0,2064986,2043144,22703.7,0.0
429,2017/1/31,2,2017,6,KURASHIRU,21164,0,2086150,2064986,22088.0,0.0
430,2017/2/1,3,2017,6,KURASHIRU,23258,0,2109408,2086150,19930.7,0.0
431,2017/2/2,4,2017,6,KURASHIRU,15370,0,2124778,2109408,20334.3,0.0
432,2017/2/3,5,2017,6,KURASHIRU,22375,0,2147153,2124778,19097.3,0.0
433,2017/2/4,6,2017,6,KURASHIRU,19547,0,2166700,2147153,22708.3,0.0
434,2017/2/5,7,2017,6,KURASHIRU,26203,0,2192903,2166700,21798.3,0.0
435,2017/2/6,1,2017,7,KURASHIRU,19645,0,2212548,2192903,22478.0,0.0
436,2017/2/7,2,2017,7,KURASHIRU,21586,0,2234134,2212548,20747.0,0.0
437,2017/2/8,3,2017,7,KURASHIRU,21010,0,2255144,2234134,21294.0,0.0
438,2017/2/9,4,2017,7,KURASHIRU,21286,0,2276430,2255144,21805.7,0.0
439,2017/2/10,5,2017,7,KURASHIRU,23121,0,2299551,2276430,22279.3,0.0
440,2017/2/11,6,2017,7,KURASHIRU,22431,0,2321982,2299551,23290.3,0.0
441,2017/2/12,7,2017,7,KURASHIRU,24319,0,2346301,2321982,22262.0,0.0
442,2017/2/13,1,2017,8,KURASHIRU,20036,0,2366337,2346301,22017.0,0.0
443,2017/2/14,2,2017,8,KURASHIRU,21696,0,2388033,2366337,21191.7,0.0
444,2017/2/15,3,2017,8,KURASHIRU,21843,0,2409876,2388033,19683.0,0.0
445,2017/2/16,4,2017,8,KURASHIRU,15510,0,2425386,2409876,18052.0,0.0
446,2017/2/17,5,2017,8,KURASHIRU,16803,0,2442189,2425386,16235.7,0.0
447,2017/2/18,6,2017,8,KURASHIRU,16394,0,2458583,2442189,16645.0,0.0
448,2017/2/19,7,2017,8,KURASHIRU,16738,0,2475321,2458583,15721.0,0.0
449,2017/2/20,1,2017,9,KURASHIRU,14031,0,2489352,2475321,15306.0,0.0
450,2017/2/21,2,2017,9,KURASHIRU,15149,0,2504501,2489352,14761.3,0.0
451,2017/2/22,3,2017,9,KURASHIRU,15104,0,2519605,2504501,15679.7,0.0
452,2017/2/23,4,2017,9,KURASHIRU,16786,0,2536391,2519605,15838.7,0.0
453,2017/2/24,5,2017,9,KURASHIRU,15626,0,2552017,2536391,15214.7,0.0
454,2017/2/25,6,2017,9,KURASHIRU,13232,0,2565249,2552017,13210.0,0.0
455,2017/2/26,7,2017,9,KURASHIRU,10772,0,2576021,2565249,12457.3,0.0
456,2017/2/27,1,2017,10,KURASHIRU,13368,0,2589389,2576021,12596.3,0.0
457,2017/2/28,2,2017,10,KURASHIRU,13649,0,2603038,2589389,14280.0,0.0
458,2017/3/1,3,2017,10,KURASHIRU,15823,0,2618861,2603038,15014.7,0.0
459,2017/3/2,4,2017,10,KURASHIRU,15572,0,2634433,2618861,15554.7,0.0
460,2017/3/3,5,2017,10,KURASHIRU,15269,0,2649702,2634433,15630.0,0.0
461,2017/3/4,6,2017,10,KURASHIRU,16049,0,2665751,2649702,15351.3,0.0
462,2017/3/5,7,2017,10,KURASHIRU,14736,0,2680487,2665751,14813.3,0.0
463,2017/3/6,1,2017,11,KURASHIRU,13655,0,2694142,2680487,14876.3,0.0
464,2017/3/7,2,2017,11,KURASHIRU,16238,0,2710380,2694142,15161.3,0.0
465,2017/3/8,3,2017,11,KURASHIRU,15591,0,2725971,2710380,15751.0,0.0
466,2017/3/9,4,2017,11,KURASHIRU,15424,0,2741395,2725971,15406.3,0.0
467,2017/3/10,5,2017,11,KURASHIRU,15204,0,2756599,2741395,14999.7,0.0
468,2017/3/11,6,2017,11,KURASHIRU,14371,0,2770970,2756599,26584.7,0.0
469,2017/3/12,7,2017,11,KURASHIRU,50179,0,2821149,2770970,41072.7,0.0
470,2017/3/13,1,2017,12,KURASHIRU,58668,0,2879817,2821149,54062.3,0.0
471,2017/3/14,2,2017,12,KURASHIRU,53340,0,2933157,2879817,53682.7,0.0
472,2017/3/15,3,2017,12,KURASHIRU,49040,0,2982197,2933157,44968.7,0.0
473,2017/3/16,4,2017,12,KURASHIRU,32526,0,3014723,2982197,36493.3,0.0
474,2017/3/17,5,2017,12,KURASHIRU,27914,0,3042637,3014723,27655.7,0.0
475,2017/3/18,6,2017,12,KURASHIRU,22527,0,3065164,3042637,23044.7,0.0
476,2017/3/19,7,2017,12,KURASHIRU,18693,0,3083857,3065164,18881.0,0.0
477,2017/3/20,1,2017,13,KURASHIRU,15423,0,3099280,3083857,16025.7,0.0
478,2017/3/21,2,2017,13,KURASHIRU,13961,0,3113241,3099280,14617.0,0.0
479,2017/3/22,3,2017,13,KURASHIRU,14467,0,3127708,3113241,13689.0,0.0
480,2017/3/23,4,2017,13,KURASHIRU,12639,0,3140347,3127708,13266.0,0.0
481,2017/3/24,5,2017,13,KURASHIRU,12692,0,3153039,3140347,12532.3,0.0
482,2017/3/25,6,2017,13,KURASHIRU,12266,0,3165305,3153039,12146.0,0.0
483,2017/3/26,7,2017,13,KURASHIRU,11480,0,3176785,3165305,12180.7,0.0
484,2017/3/27,1,2017,14,KURASHIRU,12796,0,3189581,3176785,15023.3,0.0
485,2017/3/28,2,2017,14,KURASHIRU,20794,0,3210375,3189581,17113.0,0.0
486,2017/3/29,3,2017,14,KURASHIRU,17749,0,3228124,3210375,18301.0,0.0
487,2017/3/30,4,2017,14,KURASHIRU,16360,0,3244484,3228124,16841.3,0.0
488,2017/3/31,5,2017,14,KURASHIRU,16415,0,3260899,3244484,15805.3,0.0
489,2017/4/1,6,2017,14,KURASHIRU,14641,0,3275540,3260899,16193.3,0.0
490,2017/4/2,7,2017,14,KURASHIRU,17524,0,3293064,3275540,17272.3,0.0
491,2017/4/3,1,2017,15,KURASHIRU,19652,0,3312716,3293064,21478.3,16.6
492,2017/4/4,2,2017,15,KURASHIRU,27259,49.7,3339975,3312716,25731.3,48.5
493,2017/4/5,3,2017,15,KURASHIRU,30283,95.7,3370258,3339975,32599.3,78.3
494,2017/4/6,4,2017,15,KURASHIRU,40256,89.4,3410514,3370258,36831.0,89.7
495,2017/4/7,5,2017,15,KURASHIRU,39954,83.9,3450468,3410514,41309.7,84.9
496,2017/4/8,6,2017,15,KURASHIRU,43719,81.5,3494187,3450468,65742.3,80.3
497,2017/4/9,7,2017,15,KURASHIRU,113554,75.4,3607741,3494187,86365.7,77.6
498,2017/4/10,1,2017,16,KURASHIRU,101824,76,3709565,3607741,106433.7,76.0
499,2017/4/11,2,2017,16,KURASHIRU,103923,76.7,3813488,3709565,95043.7,77.0
500,2017/4/12,3,2017,16,KURASHIRU,79384,78.4,3892872,3813488,76809.3,77.2
501,2017/4/13,4,2017,16,KURASHIRU,47121,76.4,3939993,3892872,56510.7,62.7
502,2017/4/14,5,2017,16,KURASHIRU,43027,33.2,3983020,3939993,46388.0,36.5
503,2017/4/15,6,2017,16,KURASHIRU,49016,0,4032036,3983020,42544.0,11.1
504,2017/4/16,7,2017,16,KURASHIRU,35589,0,4067625,4032036,37994.0,0.0
505,2017/4/17,1,2017,17,KURASHIRU,29377,0,4097002,4067625,30856.3,0.0
506,2017/4/18,2,2017,17,KURASHIRU,27603,0,4124605,4097002,26991.7,0.0
507,2017/4/19,3,2017,17,KURASHIRU,23995,0,4148600,4124605,24885.7,3.2
508,2017/4/20,4,2017,17,KURASHIRU,23059,9.6,4171659,4148600,23898.0,9.8
509,2017/4/21,5,2017,17,KURASHIRU,24640,19.8,4196299,4171659,26569.7,24.5
510,2017/4/22,6,2017,17,KURASHIRU,32010,44.2,4228309,4196299,31881.3,47.1
511,2017/4/23,7,2017,17,KURASHIRU,38994,77.4,4267303,4228309,37335.3,59.6
512,2017/4/24,1,2017,18,KURASHIRU,41002,57.3,4308305,4267303,40896.0,51.6
513,2017/4/25,2,2017,18,KURASHIRU,42692,20.2,4350997,4308305,43167.3,29.7
514,2017/4/26,3,2017,18,KURASHIRU,45808,11.5,4396805,4350997,41661.0,19.3
515,2017/4/27,4,2017,18,KURASHIRU,36483,26.3,4433288,4396805,42562.0,28.2
516,2017/4/28,5,2017,18,KURASHIRU,45395,46.8,4478683,4433288,40661.3,38.1
517,2017/4/29,6,2017,18,KURASHIRU,40106,41.3,4518789,4478683,41263.7,42.0
518,2017/4/30,7,2017,18,KURASHIRU,38290,38,4557079,4518789,43872.7,50.8
519,2017/5/1,1,2017,19,KURASHIRU,53222,73.1,4610301,4557079,50358.3,68.2
520,2017/5/2,2,2017,19,KURASHIRU,59563,93.6,4669864,4610301,61631.7,85.8
521,2017/5/3,3,2017,19,KURASHIRU,72110,90.7,4741974,4669864,68805.0,97.6
522,2017/5/4,4,2017,19,KURASHIRU,74742,108.5,4816716,4741974,68150.0,102.5
523,2017/5/5,5,2017,19,KURASHIRU,57598,108.4,4874314,4816716,64063.7,116.7
524,2017/5/6,6,2017,19,KURASHIRU,59851,133.1,4934165,4874314,61733.7,129.9
525,2017/5/7,7,2017,19,KURASHIRU,67752,148.1,5001917,4934165,61559.7,139.9
526,2017/5/8,1,2017,20,KURASHIRU,57076,138.5,5058993,5001917,62788.7,141.3
527,2017/5/9,2,2017,20,KURASHIRU,63538,137.3,5122531,5058993,61008.7,129.9
528,2017/5/10,3,2017,20,KURASHIRU,62412,113.9,5184943,5122531,62754.0,113.2
529,2017/5/11,4,2017,20,KURASHIRU,62312,88.5,5247255,5184943,64620.0,92.2
530,2017/5/12,5,2017,20,KURASHIRU,69136,74.3,5316391,5247255,70088.7,80.9
531,2017/5/13,6,2017,20,KURASHIRU,78818,79.9,5395209,5316391,73875.0,76.5
532,2017/5/14,7,2017,20,KURASHIRU,73671,75.4,5468880,5395209,63266.0,63.1
533,2017/5/15,1,2017,21,KURASHIRU,37309,33.9,5506189,5468880,49367.7,36.4
534,2017/5/16,2,2017,21,KURASHIRU,37123,0,5543312,5506189,35837.7,11.3
535,2017/5/17,3,2017,21,KURASHIRU,33081,0,5576393,5543312,34230.3,0.0
536,2017/5/18,4,2017,21,KURASHIRU,32487,0,5608880,5576393,32260.3,0.0
537,2017/5/19,5,2017,21,KURASHIRU,31213,0,5640093,5608880,32777.3,0.0
538,2017/5/20,6,2017,21,KURASHIRU,34632,0,5674725,5640093,32663.7,0.0
539,2017/5/21,7,2017,21,KURASHIRU,32146,0,5706871,5674725,30828.7,0.0
540,2017/5/22,1,2017,22,KURASHIRU,25708,0,5732579,5706871,28015.0,0.0
541,2017/5/23,2,2017,22,KURASHIRU,26191,0,5758770,5732579,26135.7,0.0
542,2017/5/24,3,2017,22,KURASHIRU,26508,0,5785278,5758770,26542.7,0.0
543,2017/5/25,4,2017,22,KURASHIRU,26929,0,5812207,5785278,26795.3,0.0
544,2017/5/26,5,2017,22,KURASHIRU,26949,0,5839156,5812207,27769.0,0.0
545,2017/5/27,6,2017,22,KURASHIRU,29429,0,5868585,5839156,25266.3,0.0
546,2017/5/28,7,2017,22,KURASHIRU,19421,0,5888006,5868585,22082.3,0.0
547,2017/5/29,1,2017,23,KURASHIRU,17397,0,5905403,5888006,18092.7,1.4
548,2017/5/30,2,2017,23,KURASHIRU,17460,4.2,5922863,5905403,17385.0,2.8
549,2017/5/31,3,2017,23,KURASHIRU,17298,4.2,5940161,5922863,17477.7,5.4
550,2017/6/1,4,2017,23,KURASHIRU,17675,7.7,5957836,5940161,17934.3,6.5
551,2017/6/2,5,2017,23,KURASHIRU,18830,7.7,5976666,5957836,18768.3,5.1
552,2017/6/3,6,2017,23,KURASHIRU,19800,0,5996466,5976666,20064.3,2.6
553,2017/6/4,7,2017,23,KURASHIRU,21563,0,6018029,5996466,19864.3,0.0
554,2017/6/5,1,2017,24,KURASHIRU,18230,0,6036259,6018029,19254.0,0.0
555,2017/6/6,2,2017,24,KURASHIRU,17969,0,6054228,6036259,17878.3,0.0
556,2017/6/7,3,2017,24,KURASHIRU,17436,0,6071664,6054228,17659.7,0.0
557,2017/6/8,4,2017,24,KURASHIRU,17574,0,6089238,6071664,17488.0,0.0
558,2017/6/9,5,2017,24,KURASHIRU,17454,0,6106692,6089238,17882.0,0.0
559,2017/6/10,6,2017,24,KURASHIRU,18618,0,6125310,6106692,18125.3,0.0
560,2017/6/11,7,2017,24,KURASHIRU,18304,0,6143614,6125310,17577.0,0.0
561,2017/6/12,1,2017,25,KURASHIRU,15809,0,6159423,6143614,16505.3,0.0
562,2017/6/13,2,2017,25,KURASHIRU,15403,0,6174826,6159423,15374.3,0.0
563,2017/6/14,3,2017,25,KURASHIRU,14911,0,6189737,6174826,15906.7,0.0
564,2017/6/15,4,2017,25,KURASHIRU,17406,0,6207143,6189737,17422.0,0.0
565,2017/6/16,5,2017,25,KURASHIRU,19949,0,6227092,6207143,19205.0,0.0
566,2017/6/17,6,2017,25,KURASHIRU,20260,0,6247352,6227092,18924.7,0.0
567,2017/6/18,7,2017,25,KURASHIRU,16565,0,6263917,6247352,16966.3,0.0
568,2017/6/19,1,2017,26,KURASHIRU,14074,0,6277991,6263917,15490.0,0.0
569,2017/6/20,2,2017,26,KURASHIRU,15831,0,6293822,6277991,15466.3,0.0
570,2017/6/21,3,2017,26,KURASHIRU,16494,0,6310316,6293822,16200.3,0.0
571,2017/6/22,4,2017,26,KURASHIRU,16276,0,6326592,6310316,15584.0,0.0
572,2017/6/23,5,2017,26,KURASHIRU,13982,0,6340574,6326592,14552.3,0.0
573,2017/6/24,6,2017,26,KURASHIRU,13399,0,6353973,6340574,14559.7,1.6
574,2017/6/25,7,2017,26,KURASHIRU,16298,4.9,6370271,6353973,14860.0,3.3
575,2017/6/26,1,2017,27,KURASHIRU,14883,4.9,6385154,6370271,15033.0,3.3
576,2017/6/27,2,2017,27,KURASHIRU,13918,0,6399072,6385154,13894.3,1.6
577,2017/6/28,3,2017,27,KURASHIRU,12882,0,6411954,6399072,13045.0,0.0
578,2017/6/29,4,2017,27,KURASHIRU,12335,0,6424289,6411954,12773.7,0.0
579,2017/6/30,5,2017,27,KURASHIRU,13104,0,6437393,6424289,13185.7,5.4
580,2017/7/1,6,2017,27,KURASHIRU,14118,16.1,6451511,6437393,15283.0,16.6
581,2017/7/2,7,2017,27,KURASHIRU,18627,33.8,6470138,6451511,16499.7,25.3
582,2017/7/3,1,2017,28,KURASHIRU,16754,26,6486892,6470138,17570.3,28.8
583,2017/7/4,2,2017,28,KURASHIRU,17330,26.6,6504222,6486892,16903.3,25.1
584,2017/7/5,3,2017,28,KURASHIRU,16626,22.8,6520848,6504222,16998.0,18.8
585,2017/7/6,4,2017,28,KURASHIRU,17038,7.1,6537886,6520848,17441.7,10.8
586,2017/7/7,5,2017,28,KURASHIRU,18661,2.5,6556547,6537886,18438.0,14.3
587,2017/7/8,6,2017,28,KURASHIRU,19615,33.4,6576162,6556547,21913.0,33.3
588,2017/7/9,7,2017,28,KURASHIRU,27463,64,6603625,6576162,23308.0,55.3
589,2017/7/10,1,2017,29,KURASHIRU,22846,68.4,6626471,6603625,24434.3,71.3
590,2017/7/11,2,2017,29,KURASHIRU,22994,81.5,6649465,6626471,23641.3,82.9
591,2017/7/12,3,2017,29,KURASHIRU,25084,98.9,6674549,6649465,24466.7,92.1
592,2017/7/13,4,2017,29,KURASHIRU,25322,96,6699871,6674549,27008.0,92.3
593,2017/7/14,5,2017,29,KURASHIRU,30618,82,6730489,6699871,27947.0,86.5
594,2017/7/15,6,2017,29,KURASHIRU,27901,81.4,6758390,6730489,30274.3,80.3
595,2017/7/16,7,2017,29,KURASHIRU,32304,77.6,6790694,6758390,29751.7,82.9
596,2017/7/17,1,2017,30,KURASHIRU,29050,89.7,6819744,6790694,28910.3,93.0
597,2017/7/18,2,2017,30,KURASHIRU,25377,111.6,6845121,6819744,27927.3,102.5
598,2017/7/19,3,2017,30,KURASHIRU,29355,106.3,6874476,6845121,26678.7,88.3
599,2017/7/20,4,2017,30,KURASHIRU,25304,47,6899780,6874476,26995.3,51.1
600,2017/7/21,5,2017,30,KURASHIRU,26327,0,6926107,6899780,26730.0,15.7
601,2017/7/22,6,2017,30,KURASHIRU,28559,0,6954666,6926107,25802.3,0.0
602,2017/7/23,7,2017,30,KURASHIRU,22521,0,6977187,6954666,23441.7,0.0
603,2017/7/24,1,2017,31,KURASHIRU,19245,0,6996432,6977187,20467.0,0.0
604,2017/7/25,2,2017,31,KURASHIRU,19635,0,7016067,6996432,19099.3,0.0
605,2017/7/26,3,2017,31,KURASHIRU,18418,0,7034485,7016067,18888.7,0.0
606,2017/7/27,4,2017,31,KURASHIRU,18613,0,7053098,7034485,18169.3,0.0
607,2017/7/28,5,2017,31,KURASHIRU,17477,0,7070575,7053098,16852.3,3.4
608,2017/7/29,6,2017,31,KURASHIRU,14467,10.2,7085042,7070575,16354.0,6.8
609,2017/7/30,7,2017,31,KURASHIRU,17118,10.2,7102160,7085042,16113.3,6.8
610,2017/7/31,1,2017,32,KURASHIRU,16755,0,7118915,7102160,17264.0,12.7
611,2017/8/1,2,2017,32,KURASHIRU,17919,27.9,7136834,7118915,17144.7,18.6
612,2017/8/2,3,2017,32,KURASHIRU,16760,27.9,7153594,7136834,17148.0,24.3
613,2017/8/3,4,2017,32,KURASHIRU,16765,17.2,7170359,7153594,16845.0,20.8
614,2017/8/4,5,2017,32,KURASHIRU,17010,17.2,7187369,7170359,16696.0,18.0
615,2017/8/5,6,2017,32,KURASHIRU,16313,19.7,7203682,7187369,17453.7,24.7
616,2017/8/6,7,2017,32,KURASHIRU,19038,37.2,7222720,7203682,19186.7,35.6
617,2017/8/7,1,2017,33,KURASHIRU,22209,49.8,7244929,7222720,20501.3,39.8
618,2017/8/8,2,2017,33,KURASHIRU,20257,32.3,7265186,7244929,21538.7,38.4
619,2017/8/9,3,2017,33,KURASHIRU,22150,33.1,7287336,7265186,22008.0,32.8
620,2017/8/10,4,2017,33,KURASHIRU,23617,33.1,7310953,7287336,22836.3,35.1
621,2017/8/11,5,2017,33,KURASHIRU,22742,39,7333695,7310953,21943.3,44.2
622,2017/8/12,6,2017,33,KURASHIRU,19471,60.5,7353166,7333695,20902.3,42.9
623,2017/8/13,7,2017,33,KURASHIRU,20494,29.3,7373660,7353166,20192.3,32.5
624,2017/8/14,1,2017,34,KURASHIRU,20612,7.8,7394272,7373660,21286.0,30.3
625,2017/8/15,2,2017,34,KURASHIRU,22752,53.7,7417024,7394272,21820.7,38.4
626,2017/8/16,3,2017,34,KURASHIRU,22098,53.7,7439122,7417024,21968.3,49.9
627,2017/8/17,4,2017,34,KURASHIRU,21055,42.3,7460177,7439122,21795.3,46.1
628,2017/8/18,5,2017,34,KURASHIRU,22233,42.3,7482410,7460177,21862.7,38.0
629,2017/8/19,6,2017,34,KURASHIRU,22300,29.5,7504710,7482410,22469.7,42.1
630,2017/8/20,7,2017,34,KURASHIRU,22876,54.6,7527586,7504710,22027.7,49.5
631,2017/8/21,1,2017,35,KURASHIRU,20907,64.5,7548493,7527586,22130.3,52.8
632,2017/8/22,2,2017,35,KURASHIRU,22608,39.4,7571101,7548493,21704.3,51.3
633,2017/8/23,3,2017,35,KURASHIRU,21598,50,7592699,7571101,21701.3,46.5
634,2017/8/24,4,2017,35,KURASHIRU,20898,50,7613597,7592699,21065.0,49.4
635,2017/8/25,5,2017,35,KURASHIRU,20699,48.1,7634296,7613597,20615.0,53.6
636,2017/8/26,6,2017,35,KURASHIRU,20248,62.8,7654544,7634296,19751.7,44.0
637,2017/8/27,7,2017,35,KURASHIRU,18308,21,7672852,7654544,18111.7,30.0
638,2017/8/28,1,2017,36,KURASHIRU,15779,6.3,7688631,7672852,16364.3,25.8
639,2017/8/29,2,2017,36,KURASHIRU,15006,50.2,7703637,7688631,15513.3,35.6
640,2017/8/30,3,2017,36,KURASHIRU,15755,50.2,7719392,7703637,15499.0,47.8
641,2017/8/31,4,2017,36,KURASHIRU,15736,43,7735128,7719392,16501.7,45.4
642,2017/9/1,5,2017,36,KURASHIRU,18014,43,7753142,7735128,17045.3,28.7
643,2017/9/2,6,2017,36,KURASHIRU,17386,0,7770528,7753142,16806.7,14.3
644,2017/9/3,7,2017,36,KURASHIRU,15020,0,7785548,7770528,15939.3,0.0
645,2017/9/4,1,2017,37,KURASHIRU,15412,0,7800960,7785548,15319.7,0.0
646,2017/9/5,2,2017,37,KURASHIRU,15527,0,7816487,7800960,15930.7,0.0
647,2017/9/6,3,2017,37,KURASHIRU,16853,0,7833340,7816487,16533.0,0.0
648,2017/9/7,4,2017,37,KURASHIRU,17219,0,7850559,7833340,16161.0,0.0
649,2017/9/8,5,2017,37,KURASHIRU,14411,0,7864970,7850559,15937.3,0.0
650,2017/9/9,6,2017,37,KURASHIRU,16182,0,7881152,7864970,14594.3,0.0
651,2017/9/10,7,2017,37,KURASHIRU,13190,0,7894342,7881152,13485.3,0.0
652,2017/9/11,1,2017,38,KURASHIRU,11084,0,7905426,7894342,12876.3,0.0
653,2017/9/12,2,2017,38,KURASHIRU,14355,0,7919781,7905426,13561.0,0.0
654,2017/9/13,3,2017,38,KURASHIRU,15244,0,7935025,7919781,14409.3,0.0
655,2017/9/14,4,2017,38,KURASHIRU,13629,0,7948654,7935025,14660.3,0.0
656,2017/9/15,5,2017,38,KURASHIRU,15108,0,7963762,7948654,15341.3,0.0
657,2017/9/16,6,2017,38,KURASHIRU,17287,0,7981049,7963762,17200.3,0.0
658,2017/9/17,7,2017,38,KURASHIRU,19206,0,8000255,7981049,16876.7,0.0
659,2017/9/18,1,2017,39,KURASHIRU,14137,0,8014392,8000255,15470.7,0.0
660,2017/9/19,2,2017,39,KURASHIRU,13069,0,8027461,8014392,13297.0,0.0
661,2017/9/20,3,2017,39,KURASHIRU,12685,0,8040146,8027461,12951.7,0.0
662,2017/9/21,4,2017,39,KURASHIRU,13101,0,8053247,8040146,13444.0,0.0
663,2017/9/22,5,2017,39,KURASHIRU,14546,0,8067793,8053247,13942.7,6.4
664,2017/9/23,6,2017,39,KURASHIRU,14181,19.1,8081974,8067793,14441.7,19.9
665,2017/9/24,7,2017,39,KURASHIRU,14598,40.6,8096572,8081974,13735.7,27.1
666,2017/9/25,1,2017,40,KURASHIRU,12428,21.6,8109000,8096572,13393.7,20.7
667,2017/9/26,2,2017,40,KURASHIRU,13155,0,8122155,8109000,13258.3,12.5
668,2017/9/27,3,2017,40,KURASHIRU,14192,15.8,8136347,8122155,13570.0,10.5
669,2017/9/28,4,2017,40,KURASHIRU,13363,15.8,8149710,8136347,13468.0,20.8
670,2017/9/29,5,2017,40,KURASHIRU,12849,30.7,8162559,8149710,12413.3,25.7
671,2017/9/30,6,2017,40,KURASHIRU,11028,30.7,8173587,8162559,11938.5,30.7
